ID,PLATFORM,DATE,MEDIA TYPE,LIKES,SHARE,COMMENTS,ENGAGEMENT
c414d19e-dbd4-4a92-8c7f-fb63c51f7f87,YOUTUBE,2024-05-10,REELS,3967,614,291,4872
64a9b2cf-01da-452a-973a-af19937f54d2,INSTAGRAM,2024-08-03,CAROUSEL,2644,109,12,2765
eb01257c-681b-4dd5-92c3-d3be14987ac0,INSTAGRAM,2024-04-08,CAROUSEL,1439,939,470,2848
24902ccb-b9d1-496b-b9a4-2a5184aea1d9,INSTAGRAM,2024-06-18,REELS,4920,988,445,6353
5a638f31-6b1f-47f7-ad94-f1f1ad7ca37f,YOUTUBE,2024-05-28,STATIC_POST,407,770,375,1552
a94db8d3-0dcc-4af8-b035-6df4d77b861d,YOUTUBE,2024-03-29,STATIC_POST,688,557,454,1699
3264be32-a7e3-4893-83cd-d5f7501282d6,INSTAGRAM,2024-11-24,STATIC_POST,1145,318,200,1663
db99369e-7ef2-41a1-a4b8-53561e3afec7,YOUTUBE,2024-12-12,STATIC_POST,4809,401,399,5609
6daaeeb5-88e5-42a6-aa91-7fb1cdec38f2,INSTAGRAM,2024-10-30,VIDEO,4093,246,122,4461
fcabe623-07d2-4744-8c51-428bf097f171,LINKEDIN,2024-01-28,STATIC_POST,3719,778,152,198,4847
60de27c2-e35b-426f-bbba-f357f93b1030,INSTAGRAM,2024-11-28,CAROUSEL,1843,75,407,2325
4dee6b60-6662-4bbf-b733-89ff5b969165,YOUTUBE,2024-06-10,STATIC_POST,4304,185,217,4706
77b3181a-7b1c-4054-aeff-d6c08900b657,LINKEDIN,2024-06-02,STATIC_POST,1049,148,187,103,1487
e2ba1fdb-283a-4a8e-871b-3aba8ba9f65e,YOUTUBE,2024-07-30,STATIC_POST,2038,483,322,2843
69db8b01-b73d-4014-83b7-ee6d7a8b3537,YOUTUBE,2024-11-06,STATIC_POST,2155,329,384,2868
f6b94bec-d061-4286-b89b-dafa6a0e8517,INSTAGRAM,2024-10-17,STATIC_POST,3241,733,413,4387
f2adfbea-54f0-49e4-b3b4-0ca36284ac27,LINKEDIN,2024-11-17,STATIC_POST,3521,375,499,67,4462
5b8e9175-d7ee-4403-84af-04d745c39907,TWITTER,2024-03-10,STATIC_POST,4215,377,500,140,5232
7b5cc09a-306e-48e3-8f76-e9f7d25f07d6,LINKEDIN,2024-10-28,TEXT,3492,111,324,147,4074
cbda4a29-1050-4213-99e1-6efd817acbbe,TWITTER,2024-07-19,TEXT,2906,342,306,134,3688
53665966-66be-43ab-8479-08bb80f1cb60,LINKEDIN,2024-09-24,TEXT,4892,871,302,205,6270
f4f94201-3a38-4279-b34c-7082007c422e,INSTAGRAM,2024-11-08,VIDEO,3021,868,399,4288
7bface64-8b23-4224-8f4e-5ca0cf2a9110,TWITTER,2024-06-12,TEXT,2793,130,6,285,3214
0014fe20-2ab6-4cd6-a80c-170c314f579b,TWITTER,2024-07-24,TEXT,412,659,33,181,1285
f04ca9a6-dbad-4ead-8087-13d4b67a8190,TWITTER,2024-01-24,VIDEO,264,515,118,69,966
8b887bb6-f02c-4d4b-a056-6d28267ec4aa,INSTAGRAM,2024-10-04,CAROUSEL,473,471,348,1292
30fb0e2b-5dd3-49cf-9dcc-fb015e34e7d7,TWITTER,2024-09-12,STATIC_POST,1032,78,73,125,1308
9e1bb7c8-945c-440d-8bc7-29222f6532fb,YOUTUBE,2024-09-16,VIDEO,3385,872,127,4384
232f142b-aae5-450a-99a0-02587dcee330,INSTAGRAM,2024-11-30,CAROUSEL,4901,836,264,6001
8d154bd8-9ab7-4b7e-91a9-59554acab961,LINKEDIN,2024-12-09,REELS,3508,579,141,225,4453
96dfe5f2-f69c-42be-a8e0-a339ab345be5,LINKEDIN,2024-09-12,REELS,3468,259,450,7,4184
8a5ffe52-fb65-4313-bfc9-d11b5cc61ef1,TWITTER,2024-12-01,VIDEO,359,748,108,251,1466
c0266742-cf8f-4366-98e4-8e935910e31f,INSTAGRAM,2024-07-24,REELS,599,787,25,1411
d7e2a56e-60e0-45e6-bb8b-0166e314742b,TWITTER,2024-01-21,VIDEO,3697,968,143,245,5053
adcdc969-fbcd-4e54-8623-0f1745c759ef,TWITTER,2024-04-13,TEXT,250,596,35,299,1180
fdcb15c2-74f4-43cb-aa05-e7e10083813f,TWITTER,2024-02-21,STATIC_POST,4620,745,471,229,6065
d81f02b2-c777-4d76-8f06-b3258cfe1b3b,INSTAGRAM,2024-10-09,VIDEO,2668,401,306,3375
4bae1f65-3758-4e68-ae46-82f1a961fcc5,TWITTER,2024-04-06,TEXT,2927,332,95,218,3572
266b8ad2-6792-43d9-b386-3d8fea9fec4e,LINKEDIN,2024-06-09,REELS,841,339,11,219,1410
57bdd665-6fd6-44ee-8860-3eed4f28fe05,INSTAGRAM,2024-03-16,VIDEO,4437,457,31,4925
3093d398-c74f-4762-8fa6-d03270f1b4a3,YOUTUBE,2024-09-26,REELS,4309,583,389,5281
426a12c4-ddd7-4d15-b9fc-f6dac35fdb43,TWITTER,2024-06-23,TEXT,288,683,225,83,1279
1468d058-8306-4384-a1f0-aa6d90f9f737,INSTAGRAM,2024-02-26,VIDEO,1083,988,399,2470
0d9e1336-cefd-40c4-8ef3-022de6c53370,INSTAGRAM,2024-08-31,STATIC_POST,2197,1000,384,3581
32014902-4e86-4f6f-be05-64db33a17d7d,INSTAGRAM,2024-11-14,REELS,504,651,300,1455
908df8f6-e848-40be-b233-dd56dba7917e,INSTAGRAM,2024-05-25,STATIC_POST,4092,774,101,4967
7440567e-e48a-4038-94da-b3118f407079,TWITTER,2024-02-25,STATIC_POST,2180,473,488,183,3324
23f87f03-68b5-4138-9ec6-425866ae5892,TWITTER,2024-02-27,VIDEO,4626,89,445,220,5380
5492c740-eadd-47e4-9a42-c3b8d12248a2,YOUTUBE,2024-08-10,VIDEO,1461,700,433,2594
b954fa85-c11d-42f2-84d5-c04136f1dfb9,INSTAGRAM,2024-09-16,STATIC_POST,964,609,168,1741
ddfa4c84-52bb-4147-80ea-9cc026f6f285,TWITTER,2024-01-14,VIDEO,2277,510,318,289,3394
be5c373c-4c43-4178-846f-4cb54f813df6,LINKEDIN,2024-07-17,REELS,2165,316,415,244,3140
05404a1f-e76a-45b5-8c7f-22e8f68fe172,YOUTUBE,2024-10-17,STATIC_POST,1084,378,292,1754
5c790021-f2b1-44b6-b385-c8f143d6bb64,INSTAGRAM,2024-06-07,REELS,4145,617,166,4928
e804da2e-2d8d-4cca-a7e5-4c1a57205e9f,INSTAGRAM,2024-03-07,REELS,3227,709,269,4205
e32ca075-c828-4e35-80fb-dc67fb504a0f,LINKEDIN,2024-08-04,STATIC_POST,4713,433,153,89,5388
b896daee-ec12-4d45-98fc-93f2e73b1d53,YOUTUBE,2024-05-26,VIDEO,4583,247,9,4839
2158998c-0dbd-46c1-b5b8-b3f677d3cfc0,LINKEDIN,2024-03-25,STATIC_POST,4208,30,454,87,4779
ded1ca46-a22b-438b-a2c7-33e00d56a89f,YOUTUBE,2024-06-10,REELS,230,687,199,1116
63d234e3-908c-418a-9d77-81878e8b9e19,INSTAGRAM,2024-11-18,CAROUSEL,2384,592,175,3151
00bb37de-7da0-4653-9a34-328f5135b804,LINKEDIN,2024-09-12,REELS,1614,721,277,159,2771
5dff2dbb-8d4e-47d9-8bfd-553fe5e4a87c,TWITTER,2024-03-19,TEXT,4612,599,458,266,5935
20afccd7-2bae-4e75-a486-294c52e7f2ab,YOUTUBE,2024-01-09,REELS,4150,221,27,4398
6a7bdaca-bb8b-4276-871e-dfe7c88fa5b9,LINKEDIN,2024-11-10,TEXT,425,330,149,258,1162
c81f3f68-3916-4dec-b30c-4a056a7b2d4e,TWITTER,2024-12-22,VIDEO,2778,114,468,233,3593
07c99623-5a17-4ef7-9b8d-f89c65b723cd,LINKEDIN,2024-12-22,REELS,2753,651,389,76,3869
a78b405c-0c96-412d-9f53-775a0839d40f,LINKEDIN,2024-11-17,REELS,3749,429,181,283,4642
236a2b2f-eddd-4cb5-9869-ddd689ca34b6,TWITTER,2024-11-20,STATIC_POST,4235,638,234,201,5308
960b7705-4978-43c0-b529-5ce07eab728e,YOUTUBE,2024-09-20,VIDEO,4900,280,395,5575
c30daaad-dee1-4909-9097-332be2f542f6,YOUTUBE,2024-09-14,REELS,3363,667,479,4509
e1a21003-5d02-48ca-b90e-3c6edf5f73ab,LINKEDIN,2024-06-27,REELS,4562,88,71,47,4768
6991bbe2-0934-454d-a7a9-ac427d3ed123,LINKEDIN,2024-09-04,REELS,1630,891,9,196,2726
6ceba9dc-92f8-480d-a180-991a3d7ecde6,LINKEDIN,2024-01-24,REELS,3653,745,141,2,4541
ace9ab3f-fd50-4736-aa75-800d463a08dd,INSTAGRAM,2024-10-12,CAROUSEL,1202,796,95,2093
34762192-4186-4a26-814d-28a85269297e,INSTAGRAM,2024-02-21,STATIC_POST,1461,643,140,2244
f3c750c0-b786-431c-adc3-766fb8230acd,INSTAGRAM,2024-09-06,CAROUSEL,2769,115,381,3265
91152f9b-90fc-4da9-8e96-b2d1c6c5fef3,LINKEDIN,2024-02-27,STATIC_POST,4115,269,323,196,4903
c8cd52fc-52a4-4c8c-b746-bc48e3bbdc70,TWITTER,2024-12-18,VIDEO,4436,372,285,46,5139
c09a40e2-a04d-4f27-8d28-e6e8509bca2d,LINKEDIN,2024-11-07,REELS,4960,400,346,252,5958
45bd5f98-7ef8-403d-a7f1-cefbd30a354f,YOUTUBE,2024-04-22,TEXT,75,558,212,845
a3eaa32a-7c2d-4880-94a0-c8b7c4a30868,TWITTER,2024-12-12,TEXT,3989,475,473,171,5108
9b3b5260-d95e-4970-be68-d887c6dec2bf,LINKEDIN,2024-11-07,TEXT,3603,685,341,41,4670
d74dba2f-0dd1-4c12-a643-5fc54b50d44a,TWITTER,2024-11-18,VIDEO,999,37,254,70,1360
4c624702-0216-4e43-9e7d-8aaa87360fd6,TWITTER,2024-03-05,TEXT,2114,882,282,120,3398
f73371fd-ba9a-44a8-b5e9-9b366748d5fc,YOUTUBE,2024-05-29,REELS,3046,702,314,4062
aad68dfe-d36b-420f-8cf4-6b599c3e1dfc,YOUTUBE,2024-05-30,TEXT,614,929,215,1758
f487a361-1a92-4392-8c32-73ad2800d041,TWITTER,2024-05-24,STATIC_POST,4819,508,473,253,6053
fed15d43-bbc6-49ab-a469-cddf9649d6c5,YOUTUBE,2024-06-01,TEXT,543,73,294,910
c04d44fa-0cc7-4a9e-bc54-b1207942e600,TWITTER,2024-05-18,TEXT,198,720,53,263,1234
da30eaea-9a8a-455d-9dc6-f55b57845eac,TWITTER,2024-09-25,TEXT,4036,826,388,291,5541
00a8f537-ba4b-41ac-98ed-836218005c57,TWITTER,2024-01-07,VIDEO,3415,7,279,65,3766
2e3a048c-fa2f-4fb0-a5ca-6e6034ccb2dd,INSTAGRAM,2024-04-02,REELS,3267,845,383,4495
8c229bf4-3bf9-4213-a310-29bf15b649b2,TWITTER,2024-08-18,TEXT,4476,91,23,56,4646
183380f6-6115-4551-99b1-a9cb986731e0,LINKEDIN,2024-05-27,TEXT,3768,200,171,29,4168
5acc34d3-9c85-47a7-a0e5-8f592744fedf,YOUTUBE,2024-10-01,TEXT,828,877,432,2137
7410df0c-a5e7-4427-a079-c31cfd07f5c4,LINKEDIN,2024-11-30,REELS,1966,993,477,7,3443
5dcb3758-c86e-40a9-a960-ee8725fa2676,INSTAGRAM,2024-10-26,REELS,3408,547,89,4044
f95d6444-9c44-49ac-9df8-4ab694077d81,YOUTUBE,2024-06-17,STATIC_POST,4875,405,295,5575
65fc66df-b011-4876-a41e-0534da3b90ef,INSTAGRAM,2024-09-18,REELS,2121,808,97,3026
385054c6-6652-48d4-9fd9-c85a74bb001f,INSTAGRAM,2024-08-12,STATIC_POST,1580,240,333,2153
f931845e-f905-4541-a5f4-3a573cf5cae0,TWITTER,2024-04-11,VIDEO,3550,455,95,275,4375
26fa99aa-d7cd-4789-8394-d92e719ee0e6,YOUTUBE,2024-10-04,STATIC_POST,4574,924,133,5631
d9a52b33-364a-42c4-9259-38cbb6f252ee,TWITTER,2024-03-31,STATIC_POST,4041,773,457,25,5296
8e5e0b5e-6129-41f0-872c-f6b38e5c5d23,INSTAGRAM,2024-10-04,REELS,3269,129,301,3699
c5367cc2-cfb8-4541-89fd-1a2b8e94e165,LINKEDIN,2024-04-18,STATIC_POST,1246,132,82,63,1523
c722bbcf-184f-4fc8-9a9e-0091f3ffa171,YOUTUBE,2024-07-14,TEXT,3914,830,17,4761
1177744d-e811-4bd1-909b-4265a97163a4,YOUTUBE,2024-07-13,VIDEO,4980,282,405,5667
13dcfbcc-be17-4bf2-a8d5-e7e3c751cd7d,INSTAGRAM,2024-11-08,VIDEO,2427,397,376,3200
ed80faca-744b-4b1d-b1dd-b1b87a7dc8eb,INSTAGRAM,2024-08-12,STATIC_POST,644,967,141,1752
b3da95c2-4581-4e7a-a06c-4a05ef89515b,TWITTER,2024-12-27,STATIC_POST,2016,303,175,179,2673
9441b16d-aa8a-4f49-8a01-027afe075791,INSTAGRAM,2024-11-25,REELS,1285,129,6,1420
2cbee186-9d1e-407f-ba66-f9608731d243,INSTAGRAM,2024-01-10,VIDEO,798,953,125,1876
e93102e7-d4bd-460c-a989-4cd34df6d93c,YOUTUBE,2024-07-29,REELS,3166,193,392,3751
2224b766-a8e9-452f-b529-a5412815d6af,LINKEDIN,2024-09-22,STATIC_POST,4666,777,372,132,5947
b295bb46-9652-4266-9767-70ae0240ce5c,LINKEDIN,2024-11-29,REELS,3968,974,288,8,5238
077c62e5-c5ed-402e-90b2-9356b8ecf1ba,INSTAGRAM,2024-09-13,STATIC_POST,2798,668,312,3778
5d68928b-d049-454a-98c9-fc7eb61cd817,YOUTUBE,2024-04-26,TEXT,807,912,393,2112
9d1d365c-659a-4500-a03c-ac0ec7b0818f,TWITTER,2024-08-28,STATIC_POST,1302,612,225,72,2211
c55f5715-5474-434b-827c-7bff706c68fa,YOUTUBE,2024-10-25,STATIC_POST,924,353,22,1299
d04bfda1-8542-4281-b650-87ed0fca1d2d,TWITTER,2024-12-16,VIDEO,1274,709,303,190,2476
ac0d72f8-8b5e-4704-a91e-f8798fad7940,TWITTER,2024-07-22,VIDEO,473,857,43,91,1464
9f57d354-3f49-48d9-84f5-7be0fe0fe14d,YOUTUBE,2024-04-14,TEXT,4131,962,382,5475
186b12fa-58d1-4228-b54f-aa77fce30951,TWITTER,2024-02-08,VIDEO,1413,60,438,119,2030
94641e3d-0382-42ff-8fae-0ef5bc0c641a,YOUTUBE,2024-09-13,TEXT,3808,146,121,4075
50145e99-6815-4694-b2b2-614d3353353a,INSTAGRAM,2024-07-27,CAROUSEL,3930,1000,82,5012
7cc2d7e8-bcb2-443c-a911-cbdd76bc48b7,YOUTUBE,2024-02-23,TEXT,1329,71,420,1820
c4f568ca-8caa-4959-b5ef-1e088b56b755,TWITTER,2024-08-18,TEXT,1406,513,144,28,2091
97d2f77c-44b8-4e84-ad39-66500c2911f3,INSTAGRAM,2024-09-04,REELS,2651,745,125,3521
e61d82e9-bee2-4bb1-9d2a-d461538c4eca,TWITTER,2024-08-29,STATIC_POST,2847,307,134,112,3400
120cf9ec-4a7c-489a-b976-f2e77df3dca8,YOUTUBE,2024-08-05,VIDEO,2738,25,346,3109
90c23050-fb70-4321-9332-cbce8230a7d0,YOUTUBE,2024-11-02,VIDEO,3781,345,156,4282
8bf78053-9ff5-46d4-a21f-ea951df8edec,TWITTER,2024-03-02,VIDEO,177,228,215,206,826
8c5ebfb0-3bdc-4a22-bd7f-c2863ab05b2f,TWITTER,2024-12-19,STATIC_POST,4782,327,256,84,5449
596d5b29-e42d-4105-a278-754444389f7d,YOUTUBE,2024-05-04,REELS,2210,761,472,3443
8ab16a18-a015-45c7-b5c1-90db44b38056,LINKEDIN,2024-06-15,STATIC_POST,866,660,354,38,1918
f9feaba4-082b-443e-80f9-c476cb4445fb,YOUTUBE,2024-08-10,STATIC_POST,3708,473,54,4235
3a5bb991-10d8-4a39-a74b-b09a2abe1675,YOUTUBE,2024-10-22,STATIC_POST,1373,98,484,1955
1165bbaa-d513-4458-9d57-95ca63332e6c,INSTAGRAM,2024-03-01,REELS,4075,272,401,4748
2298551b-9ec1-472f-a515-816d4c60ed55,INSTAGRAM,2024-07-05,STATIC_POST,348,307,219,874
cb3cd350-f53e-4127-8c5f-6c0f7073b823,YOUTUBE,2024-10-16,TEXT,912,549,461,1922
a5041d59-4520-463d-86cb-d662679a6468,YOUTUBE,2024-07-26,VIDEO,854,266,474,1594
34dd8b87-0f24-4939-84c3-c8760eaa5251,TWITTER,2024-07-09,TEXT,4272,706,248,82,5308
b644e620-f43f-499e-98ce-d41c438f8f5d,YOUTUBE,2024-02-25,REELS,2179,657,144,2980
433fc052-f6aa-4e80-b494-d1a19a7916c0,YOUTUBE,2024-05-07,TEXT,3254,904,313,4471
1b04457c-2367-48b7-b6ea-323f22fb8d1f,TWITTER,2024-03-18,TEXT,2349,126,50,89,2614
aac9f281-5c2d-429e-9c23-973815e9e830,INSTAGRAM,2024-07-27,VIDEO,3013,947,206,4166
53cd0b33-9aad-48be-8be4-e4f0c4037458,YOUTUBE,2024-05-17,REELS,3015,34,132,3181
05443be4-8f6a-496b-b91e-c5a71db57664,YOUTUBE,2024-02-04,REELS,4656,49,351,5056
83a71694-7620-4ca9-b9e8-38b6399028be,TWITTER,2024-10-05,STATIC_POST,782,19,370,243,1414
933ae7f0-6c77-4b81-b34d-710674133a7f,LINKEDIN,2024-08-15,STATIC_POST,1056,386,242,187,1871
4806f15c-9b6b-4afe-99e2-8280f55f2998,INSTAGRAM,2024-03-23,CAROUSEL,463,315,372,1150
03dfc31c-d041-4ea1-b2ca-8c907a34ab93,LINKEDIN,2024-07-10,STATIC_POST,239,253,335,36,863
ca6ee29f-c2a8-4899-be11-95a5c58416a8,TWITTER,2024-10-05,STATIC_POST,959,649,97,281,1986
fd8cac79-38d4-4480-9071-06ec17a3b1fd,YOUTUBE,2024-07-23,STATIC_POST,731,431,305,1467
f15f2cd4-d913-4345-bb55-b9b8571a9e91,YOUTUBE,2024-05-17,VIDEO,961,592,447,2000
1dccaff7-15b9-4203-bf9f-290e9aa3ddc4,LINKEDIN,2024-12-13,STATIC_POST,611,121,397,199,1328
f45af701-75e7-479c-aa0c-dd077b7d8fc3,TWITTER,2024-01-12,VIDEO,92,605,302,57,1056
fc149676-33e4-4fde-9ac8-3814e8d08aae,LINKEDIN,2024-06-27,STATIC_POST,859,841,223,125,2048
c9069541-25aa-4aa9-9ed4-c8bf4663e9f8,YOUTUBE,2024-11-10,TEXT,2751,369,21,3141
806e0cf2-68c5-4a19-8579-39c36278a2a0,YOUTUBE,2024-01-12,REELS,177,719,73,969
1b4163f3-59d6-4717-a9f2-e1189151458c,LINKEDIN,2024-11-06,STATIC_POST,1132,590,186,288,2196
c39865b2-27f2-4a66-b05c-2a7647281181,LINKEDIN,2024-12-23,REELS,906,206,141,83,1336
461255b5-b5a2-4dc3-a1ee-8047d55b8971,LINKEDIN,2024-06-16,REELS,1550,221,200,46,2017
0485a854-8251-40c4-99aa-a1b5ff38f3ca,INSTAGRAM,2024-12-06,CAROUSEL,2568,876,16,3460
044eded4-5dfb-43c5-b15e-98514542cdd7,TWITTER,2024-09-09,VIDEO,686,313,127,94,1220
542f8206-7f0f-429b-a958-369e68430c8b,TWITTER,2024-04-18,VIDEO,1650,447,216,261,2574
6691b5c4-2d41-44d0-ba7c-ab97af6f9bf3,LINKEDIN,2024-09-17,REELS,4594,625,471,3,5693
d8d8155c-aa12-4874-874c-fa47edc1d984,LINKEDIN,2024-04-17,TEXT,2921,798,72,18,3809
96fe118d-b662-47b0-900f-b35da6ce208a,TWITTER,2024-06-04,TEXT,1017,749,402,70,2238
b4bf058d-dcb9-4a75-9934-2bd29eb0f5cf,INSTAGRAM,2024-07-05,STATIC_POST,179,539,452,1170
4834b02e-1d01-436b-8ea4-c92b69d0c5ee,TWITTER,2024-11-09,TEXT,2817,953,320,146,4236
b332163b-549c-4c95-bc50-f434a0723fbf,TWITTER,2024-01-09,TEXT,1398,647,166,61,2272
ca335206-7606-41d1-a862-57ef4b065fb8,TWITTER,2024-05-25,STATIC_POST,42,392,106,157,697
c0d91408-240a-4fd9-a3b8-480149eec9ac,INSTAGRAM,2024-08-20,REELS,4731,151,111,4993
278c8147-04c2-47a0-8175-2216bd0654ab,YOUTUBE,2024-09-19,STATIC_POST,4143,665,115,4923
f6c3bef8-1d0c-47ef-aeff-c828a481c3cf,INSTAGRAM,2024-09-10,STATIC_POST,3212,125,197,3534
de8bcfed-34dd-4379-9845-c3a79dfca03b,TWITTER,2024-02-03,VIDEO,1509,254,437,4,2204
4750f51d-a0a9-48f0-ba1c-83fef77f3976,INSTAGRAM,2024-03-27,REELS,3788,806,158,4752
c293e303-94ab-43fb-8f99-4d3b593d1972,YOUTUBE,2025-01-02,REELS,4039,617,225,4881
660d5bb3-dc02-4136-9e1d-19d960a9bf64,INSTAGRAM,2024-10-18,VIDEO,1992,464,421,2877
60e9797a-1611-43b1-bffc-62cd1c360525,YOUTUBE,2024-12-25,REELS,935,974,117,2026
9851e2fa-ec41-4a52-9df0-dcd8cce4e15e,LINKEDIN,2024-11-07,STATIC_POST,3439,748,461,34,4682
459b4484-8b63-4244-a810-4770c32b3a37,INSTAGRAM,2024-06-07,REELS,2619,182,270,3071
b849a9e3-35eb-458b-aa73-0a44d9ed4dac,LINKEDIN,2024-08-13,REELS,2493,930,51,139,3613
540bfdae-6add-4976-acc4-265348cc509b,TWITTER,2024-09-26,TEXT,1130,107,121,1,1359
92a7d4af-ea53-4ce4-b35f-2ebee65bf3a9,TWITTER,2024-12-22,TEXT,2926,583,100,253,3862
4d4dd1fd-b982-43fb-ad49-0ed5580b6594,INSTAGRAM,2024-11-21,REELS,4745,53,17,4815
17cdba23-dfb7-4ce6-985f-8ce53e7daff5,LINKEDIN,2024-11-10,REELS,2573,103,383,157,3216
fe5499c1-839f-4dfe-8155-8c19e7b63ee6,INSTAGRAM,2024-10-20,STATIC_POST,1475,882,441,2798
9c4879a2-7b17-4539-9d4d-72d05512a2a8,LINKEDIN,2024-03-13,REELS,4948,853,331,288,6420
7166973c-930b-460d-89b9-f85efebc8fd0,TWITTER,2024-07-15,TEXT,2361,123,338,114,2936
d924fa21-6df6-4cbe-925f-9c140bd34a43,LINKEDIN,2024-01-30,STATIC_POST,2711,939,72,300,4022
6d3f9070-d0d2-4219-94f4-142cdf0a107d,INSTAGRAM,2024-05-24,CAROUSEL,4468,216,410,5094
b8b5f9b8-06fc-4a0e-b45b-07704e200c02,TWITTER,2024-11-02,VIDEO,1138,754,333,218,2443
08cb26fd-4bff-4b0f-b05f-8827b6fc20f6,LINKEDIN,2024-07-01,REELS,2838,519,179,234,3770
ba659513-7761-4575-8b80-97498a7f2244,LINKEDIN,2024-04-30,STATIC_POST,883,234,431,81,1629
00174b5c-b248-47b6-b1de-0154f0e63ea3,YOUTUBE,2024-04-23,REELS,4126,908,218,5252
d0ea211e-d0fd-4818-810a-bea1421b0ac3,LINKEDIN,2024-07-25,STATIC_POST,613,854,449,160,2076
a41eb703-0a6c-4ed9-adf8-33ef77160be4,LINKEDIN,2024-06-03,TEXT,2290,559,178,21,3048
85c4dfff-45a4-44f4-8928-1995bdcc61c9,TWITTER,2024-09-21,TEXT,421,454,187,205,1267
a93dd995-1fd0-4aa2-9399-a01ddcd61575,YOUTUBE,2024-11-30,REELS,367,52,438,857
4c05c808-794b-4ec9-bb16-3ec8475fd73a,INSTAGRAM,2024-04-12,REELS,4256,265,50,4571
39136da3-31e3-4419-b15c-0c62c5248256,YOUTUBE,2024-11-27,VIDEO,2451,929,485,3865
d560d535-20c4-4ec4-95e7-6d2c3891fb80,INSTAGRAM,2024-07-23,STATIC_POST,4994,684,402,6080
668681e3-e9b5-4541-9e84-7d3a5637e176,LINKEDIN,2024-10-16,REELS,1607,785,459,78,2929
a06c14d8-19f2-44fc-972d-60390759bba3,YOUTUBE,2024-02-21,REELS,832,480,11,1323
b7de01c6-aa63-42fd-b70c-bb08f551f0d1,LINKEDIN,2024-02-20,TEXT,2049,158,39,131,2377
c1c3ab23-166e-47fb-b74c-071a7b8623cf,INSTAGRAM,2024-12-05,CAROUSEL,224,275,197,696
ea5a9c77-ae7d-4372-9a53-e21792ba13a0,LINKEDIN,2024-02-22,REELS,3012,255,47,264,3578
20dea6ca-40e9-4b93-8969-e5d82de1427e,TWITTER,2024-06-27,TEXT,3413,186,102,100,3801
457aa46c-4560-4a38-b99f-99582fe378af,LINKEDIN,2024-05-05,REELS,4693,817,192,248,5950
e32f21e2-cb9f-4a93-8c3e-4897bbdf8109,INSTAGRAM,2024-08-27,VIDEO,275,537,69,881
18308e31-ec0a-49e4-b798-2117b6f5dda9,INSTAGRAM,2024-10-19,REELS,3125,95,359,3579
226f6a67-527c-4d5d-a1be-95b67b99b07b,TWITTER,2024-09-23,STATIC_POST,2504,165,399,228,3296
e8d51778-1e86-4a9e-9b65-7b003a57629c,INSTAGRAM,2024-11-19,VIDEO,2493,254,139,2886
91b7d7cd-c318-498e-bbe2-ede32d755d17,LINKEDIN,2024-12-10,TEXT,3478,372,195,47,4092
dca7e2b8-4422-41ed-8941-88bcee443fa4,INSTAGRAM,2024-09-20,STATIC_POST,4018,646,319,4983
d2fd1eac-99ce-42fb-b04c-5374e33e85ac,TWITTER,2024-12-19,STATIC_POST,1044,289,377,51,1761
2d082f13-6006-4510-8804-0d026e45757c,YOUTUBE,2024-03-26,REELS,4006,763,287,5056
27f810a6-afdd-4692-8c7e-0e30a8980bff,LINKEDIN,2024-02-29,STATIC_POST,3008,740,175,162,4085
00a5cf97-79c4-4722-a91f-264cc2e9d8d8,YOUTUBE,2024-04-30,TEXT,3909,436,256,4601
3d7c76f3-7fc9-4c56-92b8-62845d8667a4,INSTAGRAM,2024-07-22,REELS,3860,156,139,4155
93c4a861-d513-4c18-a35f-f830f6a37bf9,INSTAGRAM,2024-07-31,VIDEO,2268,425,128,2821
d835b07e-64cf-422e-83b5-c907adf103aa,LINKEDIN,2024-12-11,STATIC_POST,2907,133,377,209,3626
01b85cc9-f895-42b3-8dbb-e656e51e107e,INSTAGRAM,2024-10-13,CAROUSEL,3088,552,368,4008
8be07cfd-f681-4bd7-bdc3-95bd17b28a11,YOUTUBE,2024-08-04,STATIC_POST,987,761,116,1864
972200b2-7da3-4629-a7d6-d381212f8f02,LINKEDIN,2024-09-07,REELS,1401,9,34,218,1662
f05bcce1-95f2-42ac-89e0-aceb3ba033ef,INSTAGRAM,2024-06-18,VIDEO,1950,242,346,2538
5453e488-53a7-4ca9-a836-ca94253d573b,TWITTER,2024-04-26,VIDEO,4817,200,287,177,5481
e9d1b665-c8e1-42e5-8af6-eb93659eabcd,YOUTUBE,2024-04-26,REELS,2602,173,3,2778
348e6a76-9f8c-4508-9b91-f12008318e31,LINKEDIN,2024-03-25,STATIC_POST,46,183,196,198,623
c5665984-4d46-40e0-be57-4a25e34500f5,LINKEDIN,2024-12-18,REELS,4655,910,95,243,5903
c263d848-6c78-4978-9dc6-bc994ab1bde8,TWITTER,2024-06-23,TEXT,2337,828,239,86,3490
02145f1f-0ef9-4181-acd7-345397953dc3,TWITTER,2024-06-10,TEXT,2354,349,195,119,3017
4cc99b91-7876-494b-bf07-6192cffad522,TWITTER,2024-12-31,VIDEO,4018,757,475,272,5522
d2085baa-ddc6-416f-92da-17a4ca0c17cd,YOUTUBE,2024-10-06,STATIC_POST,43,790,396,1229
1a80ad1a-85c4-402f-92b9-e93f32f00f46,INSTAGRAM,2024-09-06,STATIC_POST,225,899,375,1499
6d9ad0a1-06a6-4a50-970d-b50ad6a5ac60,TWITTER,2024-02-05,STATIC_POST,2770,189,113,132,3204
d9355215-4431-4cbe-a689-4406409476de,TWITTER,2024-04-27,STATIC_POST,2130,242,352,51,2775
45e7d3cc-632f-44f0-82c9-9e1e4bbeb4ee,INSTAGRAM,2025-01-01,VIDEO,1774,837,478,3089
2b0e6720-8c0b-4c78-8f6a-e48931d81fc0,TWITTER,2024-12-27,VIDEO,849,665,405,84,2003
bf430652-1a73-42ec-a8f1-cd2fe7ece130,YOUTUBE,2024-08-17,REELS,3921,329,471,4721
cd08bcb7-d15e-4a42-bf93-163324bc576b,INSTAGRAM,2024-09-25,REELS,3965,461,56,4482
faa1a4f4-f8bf-4ed5-a286-54acb1e76e74,TWITTER,2024-08-18,TEXT,109,258,168,172,707
b2a1daa8-387f-46d1-8b13-4d39668bf57f,INSTAGRAM,2024-08-05,STATIC_POST,3207,427,480,4114
fe8281e2-854a-4609-930d-01f2422045ea,INSTAGRAM,2024-12-19,VIDEO,1624,668,284,2576
57a68420-afb8-411a-97ad-92dfdc11f066,YOUTUBE,2024-03-04,TEXT,137,877,177,1191
684a7a64-fb89-4578-b769-977399d1b85f,LINKEDIN,2024-11-29,REELS,4160,64,115,125,4464
56d7b453-fa54-4fcd-ad53-b8e9f3734b11,LINKEDIN,2024-04-10,STATIC_POST,2493,475,270,76,3314
3aa2e4bc-a957-4143-ad38-79f9b90a8624,TWITTER,2024-09-10,STATIC_POST,2918,157,487,195,3757
6e228d0f-355f-4df6-89ae-ab6fdf0b4fa8,TWITTER,2024-12-03,VIDEO,4827,858,488,128,6301
88520705-013d-4fee-b5f3-69fa4961e20e,YOUTUBE,2024-06-13,TEXT,3096,546,70,3712
7ac7004d-47d4-4f3b-a870-592c740fd447,INSTAGRAM,2024-11-10,STATIC_POST,1416,395,115,1926
2faf0a5e-3920-418b-b6dc-8b25839c1ffb,LINKEDIN,2024-10-27,TEXT,1338,277,38,182,1835
c892b6d7-d165-477f-9320-997d69cf86c5,YOUTUBE,2024-12-22,STATIC_POST,849,355,354,1558
a52f995e-d550-48b7-adc6-3fff6d7ef4d8,YOUTUBE,2024-09-04,VIDEO,4868,934,372,6174
ce2f0e87-557c-4a8a-b906-c9f64ed64848,LINKEDIN,2024-12-19,REELS,3628,9,384,119,4140
881df809-92f6-46d8-8285-e3782b494090,LINKEDIN,2024-12-14,STATIC_POST,4828,609,40,20,5497
81357125-b4ed-42bf-bd6f-fde1c5b27390,INSTAGRAM,2024-04-21,VIDEO,2216,328,262,2806
3ccf477f-52a2-43c8-8619-d795073c0448,YOUTUBE,2024-09-22,VIDEO,3618,114,371,4103
70f2f14b-3678-4bc2-8ef9-40ca537d50d1,LINKEDIN,2024-09-22,TEXT,4195,194,129,166,4684
68345028-9827-4a9e-b9a1-52ca49a5c7b3,INSTAGRAM,2024-08-22,VIDEO,3708,895,55,4658
ffa54282-3fb5-4b5f-b462-4399b5e2e7a1,YOUTUBE,2024-10-03,REELS,399,632,244,1275
8434615a-6fcb-415e-90b9-ba7da6d69487,LINKEDIN,2024-02-05,TEXT,4225,893,446,73,5637
c1a70844-26cb-4a9b-9dc6-d51efe6c6db5,TWITTER,2024-07-28,TEXT,880,962,458,209,2509
c3b79812-e25a-4163-a48d-b79cea0f00d9,TWITTER,2024-06-05,STATIC_POST,947,620,455,160,2182
e66aad84-3d0a-44cf-93cf-b6537797f586,LINKEDIN,2024-07-01,REELS,1905,856,230,37,3028
713315dd-cfac-4e0f-9eb0-1f521c1bc426,LINKEDIN,2024-10-18,STATIC_POST,61,838,31,201,1131
9a2cebe6-f418-41ff-adba-d083df5a3ac4,TWITTER,2024-10-13,TEXT,3564,685,413,225,4887
253e13f7-6809-4073-ad28-aafabfcaf330,YOUTUBE,2024-04-18,REELS,4323,702,153,5178
9444e295-948a-4074-8a8d-d0941d1c78ce,LINKEDIN,2024-09-14,REELS,4790,92,211,95,5188
0919b2c1-1248-46f3-9ef7-565aacb95238,INSTAGRAM,2024-05-20,STATIC_POST,2288,425,171,2884
3b23c998-5358-4036-b5ff-b74c6c35114c,INSTAGRAM,2024-08-31,STATIC_POST,1457,521,158,2136
dad99ced-2843-4a5a-b1d3-82bfe478d9e9,INSTAGRAM,2024-02-18,VIDEO,3166,241,200,3607
a3f3f766-7fb9-41a9-94c2-0277d72b846a,INSTAGRAM,2024-09-15,STATIC_POST,62,547,374,983
158d73c1-9403-4a4b-869e-2bc2442f2ef5,TWITTER,2024-09-22,STATIC_POST,483,946,375,295,2099
a28d64d9-a969-4016-8bc5-856b3de2863d,TWITTER,2024-06-25,TEXT,1986,975,49,298,3308
5d55702e-7aa2-4e6d-8b69-89805a632191,INSTAGRAM,2024-05-23,STATIC_POST,1878,657,416,2951
c8de920e-555f-4118-8c78-9dcd5c22e639,INSTAGRAM,2024-07-11,VIDEO,1858,383,304,2545
00c1f56b-5362-422f-a591-b8c80ed48e55,LINKEDIN,2024-07-30,TEXT,1040,817,12,151,2020
856e9bfc-d7d4-44d3-9a0f-0868f753bd9d,TWITTER,2024-07-16,VIDEO,4432,5,482,2,4921
745a56e6-a0b7-490e-92f1-11861b28a9eb,INSTAGRAM,2024-06-03,REELS,3092,275,320,3687
1f732251-857a-42b5-9653-3c8a74e3d599,INSTAGRAM,2024-06-20,VIDEO,287,399,339,1025
acb823f2-3961-4b25-a9e2-f058cc47629b,INSTAGRAM,2024-02-07,STATIC_POST,3798,409,72,4279
dba51aec-3686-4c44-98af-1134c7171a77,LINKEDIN,2024-04-23,REELS,1078,934,236,274,2522
a24a18fd-2fa2-418e-8a42-f2bb27032602,INSTAGRAM,2024-09-23,STATIC_POST,3950,444,247,4641
567cdbbc-ddc0-479e-803e-4b97b002e7a7,LINKEDIN,2024-07-15,TEXT,2262,65,433,156,2916
a78666db-fa9b-40ce-9447-25e7e9c85a14,TWITTER,2024-11-06,STATIC_POST,4998,227,241,201,5667
565513e3-4967-4fa9-bc74-399182724688,TWITTER,2024-06-14,TEXT,686,199,44,38,967
3411581a-9e83-4742-8dce-46ea4a7abf90,LINKEDIN,2024-07-27,TEXT,1554,80,88,217,1939
7db610c8-acd0-408a-aebd-f08ca4c43613,INSTAGRAM,2024-07-03,CAROUSEL,854,635,424,1913
91f5286c-0c80-4b36-8476-42e4c772b2c1,INSTAGRAM,2024-02-01,CAROUSEL,1266,608,71,1945
bfb257a7-6a07-4552-8602-53f9762b1a2b,INSTAGRAM,2024-09-04,CAROUSEL,1949,225,97,2271
667cb8da-a33f-42e1-a24c-ac6a364c41a8,LINKEDIN,2024-09-10,REELS,1012,221,344,46,1623
74881e88-8d31-4dbd-9588-530f8a947b45,YOUTUBE,2024-08-26,VIDEO,3867,472,468,4807
f6ba7e0b-fd64-4c9a-bd14-b2838dd2c2e6,YOUTUBE,2024-12-10,TEXT,1803,826,347,2976
9597a16a-3eb9-4922-9079-fead39d55f9f,YOUTUBE,2024-04-21,TEXT,1983,735,387,3105
620a951a-823a-4f35-9eca-f176c2972971,INSTAGRAM,2024-03-28,REELS,2035,649,404,3088
3c52eba2-a4d0-4e18-ac0a-06fa85dea65a,YOUTUBE,2024-01-22,VIDEO,2020,635,275,2930
d4602cf8-823a-453f-b3c2-f11371b210a5,LINKEDIN,2024-12-24,STATIC_POST,2279,708,41,218,3246
2d642377-705b-4673-ba69-cbdbe10a6288,LINKEDIN,2024-04-05,REELS,604,971,2,37,1614
a641056e-9ffb-4e4d-9148-dc16f8027366,YOUTUBE,2024-11-29,REELS,2691,710,337,3738
6ad1733d-02f8-4617-b241-849ee97fe0fc,LINKEDIN,2024-05-15,REELS,2652,547,350,256,3805
67741481-5de4-4c4b-acbd-ae8cc5c57154,LINKEDIN,2024-09-05,REELS,841,869,406,220,2336
709b89af-ecec-4abc-8a92-9e9c8839c7dd,YOUTUBE,2024-06-02,TEXT,3419,895,248,4562
9fe73316-e326-40cb-96d8-b4ca456ae8cb,LINKEDIN,2024-03-02,TEXT,1097,304,57,300,1758
953190da-0c16-4c58-85ca-a21685de9323,YOUTUBE,2024-11-17,TEXT,1621,179,225,2025
5220806a-9226-4571-b4d8-524527a2050e,YOUTUBE,2024-03-07,TEXT,4527,748,388,5663
8401b43c-8962-4a14-8090-70383cd3a22e,TWITTER,2024-12-08,STATIC_POST,4575,481,322,226,5604
6137f8d7-8a5d-47b1-899c-40dd2d5434fa,INSTAGRAM,2024-03-04,VIDEO,4297,118,303,4718
245df187-2c99-426e-b986-95f55eb5b989,LINKEDIN,2024-07-16,STATIC_POST,1583,438,49,36,2106
50e97352-c630-4d90-8fe0-d4d86a408aad,YOUTUBE,2024-08-29,REELS,2989,389,286,3664
adfe5498-6dee-4312-a439-c461f69da877,TWITTER,2024-06-16,STATIC_POST,4113,533,112,152,4910
04e6bb3e-d534-4640-adef-9cb460c9a670,LINKEDIN,2024-11-10,STATIC_POST,3815,679,485,117,5096
726d8a92-e3cb-4c86-9af0-8adc1f30da08,INSTAGRAM,2024-02-19,STATIC_POST,1819,137,69,2025
7669f39f-7b20-4c0a-8c4b-13ca2826da29,YOUTUBE,2024-08-12,STATIC_POST,1996,656,56,2708
7fb3c3be-e5c6-49de-a708-9bc7c1dbe84b,LINKEDIN,2024-11-20,REELS,3811,460,205,141,4617
9356db81-8020-4183-ad9b-b74d12e9be74,INSTAGRAM,2024-06-22,VIDEO,905,961,226,2092
5535990b-7219-4cbe-a729-aedec59b99c3,TWITTER,2024-05-10,VIDEO,2348,253,78,54,2733
36a3e694-95f3-4431-a23e-cf1b668d6ac1,LINKEDIN,2024-02-02,STATIC_POST,4875,612,401,23,5911
40f6d400-0609-42c0-ae2a-7c50cbb3cb15,INSTAGRAM,2024-11-02,STATIC_POST,346,100,236,682
46ccd79d-ff6d-415f-897c-f588dfb1559c,LINKEDIN,2024-09-18,REELS,869,417,273,28,1587
f3b34662-9279-4bf5-b7a1-97a1c5702e4b,INSTAGRAM,2024-02-13,STATIC_POST,1718,741,273,2732
8044e9f0-2ef3-41f3-9a16-bbc9f9d0a8ca,INSTAGRAM,2024-06-06,STATIC_POST,2084,945,342,3371
5141f6d0-f48a-4e33-8bbe-377d1cf2a523,INSTAGRAM,2024-04-21,VIDEO,3481,731,192,4404
f2c42386-7adb-495d-abdf-bb740e0842ff,LINKEDIN,2024-10-14,REELS,2958,243,303,210,3714
d3fc4425-9ce1-496e-8afd-703270883fb1,YOUTUBE,2024-11-12,VIDEO,4048,308,441,4797
559ad2a5-9da2-4e37-9e72-6c5e200f3e91,TWITTER,2024-03-25,VIDEO,864,82,57,20,1023
8ba1c23f-499c-49f4-b963-9ba1940596db,INSTAGRAM,2024-04-13,CAROUSEL,3186,597,166,3949
36b91261-0692-4ddb-ac92-f9d42f34e22a,INSTAGRAM,2024-12-07,REELS,3894,860,455,5209
d433b726-df70-407b-8ae5-d001b3e1f069,LINKEDIN,2024-08-15,STATIC_POST,1135,857,170,150,2312
b2c43b98-5dd4-40b6-8b36-dbc7b5f01440,YOUTUBE,2024-08-09,REELS,2275,803,440,3518
98eaf4a8-5869-4014-8eb6-98c24ddb45ca,INSTAGRAM,2024-06-10,CAROUSEL,3723,855,105,4683
e34acd3a-b4c9-4dea-ad58-92e49b0b33cd,LINKEDIN,2024-01-16,REELS,1899,285,249,177,2610
7271a2ea-2666-40e9-ab57-717d13ac87a4,LINKEDIN,2024-08-02,TEXT,4538,899,170,188,5795
49f1f5af-dde0-4db2-8170-a9fb4b6b3752,YOUTUBE,2024-03-27,VIDEO,2696,747,272,3715
71d7b9a1-5cb6-4c93-b894-489e6d1a1a85,YOUTUBE,2024-08-03,VIDEO,441,6,120,567
82cc2fdc-ba0d-47f4-bbd4-990876ad4227,TWITTER,2024-05-09,VIDEO,1854,66,499,18,2437
fb81c410-a65a-4aeb-843a-5bad128f6021,INSTAGRAM,2024-09-24,REELS,3870,302,28,4200
bbb4b0aa-425c-4cfc-9838-ae3d88026779,YOUTUBE,2024-09-04,REELS,2424,583,478,3485
262a45b7-1172-419b-a655-c934bb6a496d,YOUTUBE,2024-03-11,REELS,1318,586,418,2322
722f308d-f090-4986-8102-05fdb81486f8,INSTAGRAM,2024-08-04,CAROUSEL,3019,811,371,4201
5549f230-ac12-4192-9502-0a7ca6e7bbfa,INSTAGRAM,2024-07-02,CAROUSEL,2217,648,96,2961
e50f7d2c-3793-496f-9db3-3089f688b129,TWITTER,2024-05-30,TEXT,3956,910,377,45,5288
cd4154cf-212c-4b65-a331-7cc4156d53d7,LINKEDIN,2024-04-11,TEXT,3132,803,263,168,4366
45bc2f96-b2fc-4207-bc44-d9e33e11dff0,LINKEDIN,2024-06-23,STATIC_POST,2052,76,283,264,2675
af575579-c6a9-4097-a07b-16035ed98f19,INSTAGRAM,2024-05-03,REELS,1839,334,221,2394
ac994cda-84f3-41df-af80-462b132ddb5f,LINKEDIN,2024-10-24,STATIC_POST,803,617,448,160,2028
96c8aae1-e08a-4bce-bbae-348f09002656,INSTAGRAM,2024-12-26,VIDEO,1192,525,500,2217
783cc58f-d461-40bf-baac-ffe3f1765bfc,LINKEDIN,2024-05-03,TEXT,2376,972,163,128,3639
93e1947b-8e20-41f6-a2ae-a1bd9717ee53,LINKEDIN,2024-11-20,TEXT,4210,343,197,17,4767
078b0c73-e1e6-4351-900f-624e3cc2c26c,INSTAGRAM,2024-06-17,VIDEO,4855,352,91,5298
c29e88d5-b3e9-47b6-a8ab-f265fc15a025,YOUTUBE,2024-09-13,REELS,510,173,92,775
a316f331-d117-48e3-9ccd-ff7b10c195c7,INSTAGRAM,2024-12-11,VIDEO,3179,493,41,3713
5e2f26ae-d60c-4989-990c-eafd06583f43,LINKEDIN,2024-05-09,TEXT,655,48,236,25,964
7319223e-4f6a-4403-970e-3980a3921f44,TWITTER,2024-07-08,STATIC_POST,1005,53,460,266,1784
192750a9-b7aa-44f5-b0a0-8cebf3c01a7f,INSTAGRAM,2024-12-21,REELS,4551,155,118,4824
f33de52d-d236-4b7f-8a8c-a70ee10c4ac8,INSTAGRAM,2024-08-13,STATIC_POST,2368,603,431,3402
5750159b-b41c-4e46-9284-ae9dd1b4f6b4,TWITTER,2024-04-20,VIDEO,1616,530,402,63,2611
caafa2e1-fbe1-48f1-a706-b108029321e9,LINKEDIN,2024-08-14,REELS,4796,522,479,68,5865
34e7beb9-3152-4ed6-a26e-861cc0e968f4,YOUTUBE,2024-03-28,TEXT,4522,758,119,5399
93cac00f-4b43-4cae-b88a-d20946c03c87,YOUTUBE,2024-06-06,REELS,3769,498,22,4289
5cf3528c-d736-4a65-878c-67d31b0c7f62,YOUTUBE,2024-05-10,VIDEO,1905,488,471,2864
1e5228d5-819a-4230-993a-0010076ad1c4,YOUTUBE,2024-09-04,TEXT,1348,986,472,2806
3cf373ef-79fc-44bf-8190-3d236fc91c3d,INSTAGRAM,2024-02-07,REELS,403,640,265,1308
2086048d-8698-4f97-adb0-c36231847845,INSTAGRAM,2024-05-04,CAROUSEL,894,585,163,1642
1d76ce30-de62-46f8-8f71-f4a48bdcba02,TWITTER,2024-02-13,VIDEO,1159,975,409,206,2749
a326cbff-928b-455b-9435-f732500fdf23,YOUTUBE,2024-03-05,STATIC_POST,4064,921,46,5031
f6c53d95-4ee9-44a7-8622-2d741af97109,INSTAGRAM,2024-04-23,VIDEO,4319,977,6,5302
a410d45d-b76d-47fa-b1ad-18715e85e57f,YOUTUBE,2024-11-24,TEXT,4086,996,198,5280
25a0fad8-7ee4-48f8-be93-8ff421f790f8,YOUTUBE,2024-06-28,VIDEO,1910,271,373,2554
d05338c2-4ea4-4c1f-9ae3-a5e5f3cf2751,YOUTUBE,2024-03-04,REELS,3090,465,224,3779
a2f0bc1f-7552-45cf-a15f-2c465e375215,LINKEDIN,2024-01-19,STATIC_POST,3459,611,250,65,4385
25574d6c-17c3-450e-b3d7-6176cbfb554b,YOUTUBE,2024-02-26,STATIC_POST,610,739,397,1746
866cd227-2812-4b45-ba36-68ffff732fdc,LINKEDIN,2024-02-10,STATIC_POST,3457,433,483,131,4504
d8e87716-25f2-4074-acda-085395f3bc19,LINKEDIN,2024-12-03,REELS,760,31,184,7,982
abe48784-3db7-4c3c-96b2-e9e286066a30,LINKEDIN,2024-05-15,STATIC_POST,2204,658,420,154,3436
0a9d7708-d7c9-4051-a9fc-2418b3dd2a35,INSTAGRAM,2024-10-12,STATIC_POST,3768,910,216,4894
f291d5b6-d8ee-43ac-bfdd-6e6f8c589f6a,INSTAGRAM,2024-04-03,VIDEO,3262,215,415,3892
55312ebd-372e-4ed5-b1d0-c2ce577c85d2,LINKEDIN,2024-08-08,TEXT,3107,196,118,132,3553
1fce47df-7c20-40de-a61e-c8957de9de04,TWITTER,2024-11-19,TEXT,2164,446,54,9,2673
fd93b325-f15a-4f31-984b-105fe4c8d741,INSTAGRAM,2025-01-05,VIDEO,3059,669,277,4005
8ee51b2b-8466-4963-81d5-e730ca2e0efb,YOUTUBE,2024-02-23,TEXT,769,420,68,1257
968942a7-2d96-444b-a8d6-3af023f35ff0,INSTAGRAM,2024-07-15,VIDEO,4041,159,126,4326
df005606-4f45-4e35-9e45-a57b28589a11,LINKEDIN,2024-09-28,STATIC_POST,4145,754,400,207,5506
de5435b2-e30f-426c-834b-a5be421868ef,INSTAGRAM,2024-07-22,VIDEO,2528,694,153,3375
e04dd249-7162-4807-8665-ebca178ee407,TWITTER,2024-10-01,VIDEO,3115,151,362,159,3787
5abfb25e-1e48-4db9-aca2-4ce35931b4cf,LINKEDIN,2024-12-30,STATIC_POST,3929,932,310,171,5342
1ae47fdd-04a5-44b5-bf4a-beb096dfe7e3,TWITTER,2024-02-03,TEXT,969,235,382,158,1744
b25b75e0-b292-49ec-b3d6-990ff2429eb5,INSTAGRAM,2024-04-07,REELS,1454,654,101,2209
4df612a4-48a3-4c94-8582-1d00ec509fb8,LINKEDIN,2024-05-28,TEXT,4061,648,249,54,5012
840b9aa7-4974-4af3-b823-80f26a8976c7,LINKEDIN,2024-08-08,TEXT,4784,615,57,36,5492
034c7549-5015-468d-b456-af4511ba22ca,INSTAGRAM,2024-11-22,VIDEO,3800,571,340,4711
a0505952-a67f-4605-9ab4-e5737adde13a,INSTAGRAM,2024-02-03,VIDEO,3908,532,147,4587
a82d9a73-8e34-4faa-aa8e-22941c9163f7,INSTAGRAM,2024-03-13,STATIC_POST,3233,852,92,4177
f4cac6a6-e6c5-4fd0-80e2-cd908704f101,INSTAGRAM,2024-12-25,CAROUSEL,1894,638,256,2788
b684a917-8956-432d-8da1-60845ff7a2a1,YOUTUBE,2024-08-05,TEXT,3888,346,115,4349
34fd4e73-5fb5-49c0-bff4-9f573c72aa9c,LINKEDIN,2024-02-12,TEXT,1113,730,458,186,2487
196cb3e6-3b5a-4e08-9882-60124d0514ab,LINKEDIN,2024-11-30,REELS,1913,187,328,193,2621
14e41e8d-7487-4cb0-9b06-21e324bb07e2,LINKEDIN,2024-05-11,REELS,522,196,357,25,1100
4da1e3c7-c24a-420c-a056-dcbe14726711,TWITTER,2024-07-06,VIDEO,4728,94,416,32,5270
4be15885-7b04-46b9-992a-6d95bcc37988,LINKEDIN,2024-05-01,STATIC_POST,788,225,399,248,1660
9d20607f-371d-4643-8cc2-2fc95b58b969,LINKEDIN,2024-09-11,REELS,1314,704,328,246,2592
422d9aa7-bb2a-4e7f-bb36-7feb020394f7,TWITTER,2024-12-02,TEXT,1610,834,257,67,2768
5bd5b4c4-0e74-440e-b635-21cad1ed9023,TWITTER,2024-09-15,VIDEO,446,268,126,236,1076
817ff37a-e4aa-4ea0-9a71-81de2738472b,TWITTER,2024-06-22,VIDEO,1078,305,229,53,1665
dbf1045a-8236-41d0-a9fb-0ad90f71206c,LINKEDIN,2024-10-28,REELS,138,714,487,92,1431
0c0b53f6-8397-451a-bf6c-52e707c06309,YOUTUBE,2024-09-08,STATIC_POST,4401,65,96,4562
b5811779-efb4-4ea8-b258-058e93e8799e,TWITTER,2024-11-27,STATIC_POST,389,952,25,284,1650
717934be-c260-4ca7-ae5e-44288565075d,LINKEDIN,2024-07-23,TEXT,3920,8,421,15,4364
4c6d64bb-1bd5-47fb-bfaf-d5318006b2b2,YOUTUBE,2024-06-21,VIDEO,2516,262,163,2941
b63d3adc-9f27-4b2b-b014-090223d957de,YOUTUBE,2024-04-18,STATIC_POST,2028,311,50,2389
5dc8d225-74bf-4d8b-8aee-7b1a672b4d13,LINKEDIN,2024-06-11,REELS,28,413,95,195,731
53ca6791-ca5f-4889-8e13-7489c1869397,YOUTUBE,2024-07-16,REELS,4117,564,475,5156
a536291b-913d-47d7-bdb3-f7c541cd45ba,LINKEDIN,2024-11-26,REELS,2075,840,123,48,3086
a2c39019-381f-4d1d-900e-aea64d600af1,LINKEDIN,2024-04-15,REELS,4575,569,4,29,5177
cf685b3e-3b79-4914-9e1c-b3202287862d,INSTAGRAM,2024-04-26,CAROUSEL,525,920,119,1564
540a3bff-f600-4027-8344-187703077339,TWITTER,2024-11-03,VIDEO,3178,721,467,260,4626
556395b2-ff4a-423b-af37-4c8a909a8886,TWITTER,2024-06-15,TEXT,2665,340,68,270,3343
9077e9e3-2967-4d36-a8af-31b927e64116,TWITTER,2024-11-14,STATIC_POST,3080,231,66,188,3565
282bf646-9551-424f-ae1e-3602081d5b29,LINKEDIN,2024-04-15,TEXT,1356,725,136,279,2496
32382b22-bf45-43ab-a8c7-eb17ca4d0916,INSTAGRAM,2024-03-07,STATIC_POST,1971,258,428,2657
037d40fe-5878-4dc4-bed8-d9c1ba972c8e,LINKEDIN,2024-11-15,TEXT,4299,28,12,286,4625
3ea8a94e-d628-4d4d-aa2c-92e9dd1bf89c,INSTAGRAM,2024-10-12,STATIC_POST,2193,744,112,3049
e86503fa-03f9-4f22-b1b3-ee06c10faaff,INSTAGRAM,2024-07-09,STATIC_POST,2605,307,301,3213
c4dc9ca1-a33e-4dec-865d-cda85a3b47fe,LINKEDIN,2024-06-20,TEXT,550,349,270,250,1419
3b4e076f-ab29-4793-9d78-e5f55c31195d,YOUTUBE,2024-08-02,VIDEO,3008,420,500,3928
78c35314-c895-4f92-b79f-af94466cb393,YOUTUBE,2024-08-31,TEXT,3686,427,187,4300
944ab130-e364-475a-a475-f2e1e573bc54,YOUTUBE,2024-02-11,VIDEO,3112,761,301,4174
4427dd8f-6902-4acd-89eb-cee03865d0e8,LINKEDIN,2024-09-15,TEXT,4423,918,338,41,5720
1268c0ba-2fa5-40ac-8a61-b34edd394717,INSTAGRAM,2024-05-07,VIDEO,3815,361,383,4559
9bdae9df-adf7-4d6d-b63a-0b6bf629dd04,TWITTER,2024-07-03,TEXT,2585,367,236,104,3292
c98a4078-1d9a-4480-bda9-38d4787c7fbd,YOUTUBE,2024-12-18,REELS,2835,199,278,3312
5cd3e4c5-a4ab-4d2e-a613-af1b91a87000,YOUTUBE,2024-07-13,STATIC_POST,420,112,393,925
86c1485a-87e5-486c-8a41-d48c7a9f5418,YOUTUBE,2024-01-07,REELS,3601,818,390,4809
32b1582a-cb40-4d61-a947-e44f611567f7,TWITTER,2024-02-17,VIDEO,265,575,277,176,1293
920e4cd4-afab-4240-91d0-41c99ee6947b,YOUTUBE,2024-10-07,TEXT,1435,629,22,2086
0efe12e3-227c-4733-b946-48622cfa5b58,LINKEDIN,2024-12-19,TEXT,4587,943,483,229,6242
80b66c56-aecf-4c30-ad3f-a170058977b3,LINKEDIN,2024-04-02,TEXT,448,791,277,227,1743
31f137cf-d1f6-4ae3-8fe4-a50b6223e1e0,LINKEDIN,2024-12-12,TEXT,1955,397,333,151,2836
ff0793d3-cdae-498c-82ea-375b2ab193f4,YOUTUBE,2024-11-10,REELS,2176,771,332,3279
db982a71-0a7f-4e0e-b608-48c79dddf843,TWITTER,2024-06-19,STATIC_POST,198,100,376,169,843
6928a3ac-d927-41de-8c5f-b3a30d51443a,TWITTER,2024-07-27,TEXT,1883,605,176,29,2693
c23ddf0f-ad86-4582-9179-f6f11a5c6b60,LINKEDIN,2024-01-20,REELS,3347,271,137,168,3923
549ec5f8-7534-49b6-b5ab-845f88fea47b,INSTAGRAM,2024-05-19,CAROUSEL,53,465,449,967
f01648c4-8fee-4b2f-a353-be45f689120d,TWITTER,2024-12-20,TEXT,4270,13,247,200,4730
2c01a9eb-3e1a-4d30-a61c-8d23d415fbce,YOUTUBE,2024-07-16,STATIC_POST,809,870,18,1697
136d56bd-78ee-4521-84ac-7e94eec2fefc,LINKEDIN,2024-06-05,REELS,544,483,402,104,1533
cfd9657b-0df7-4b10-a56f-528076e7a603,INSTAGRAM,2024-11-26,VIDEO,2549,669,77,3295
8d93ffe0-08fe-4d85-ab23-14d12d0f9b7a,LINKEDIN,2024-01-20,REELS,631,831,174,144,1780
a390a8f8-7e1e-4837-a02c-7f0aa55347a2,YOUTUBE,2024-04-05,VIDEO,3687,525,400,4612
8a230033-b2e9-4580-8013-4750e206618f,LINKEDIN,2024-08-13,TEXT,4669,444,233,199,5545
9c7054ea-a370-47c9-9320-2bae1d97914d,INSTAGRAM,2024-04-17,STATIC_POST,4393,945,60,5398
8d6dc18d-ea63-4ac0-b0b7-ab8ada3ea9f3,TWITTER,2024-05-16,TEXT,132,441,184,150,907
857c4f38-2b22-4fa0-af5e-5b2c1ea465a8,LINKEDIN,2024-03-14,TEXT,4154,542,443,227,5366
1a66b871-065c-4944-b31f-41736c581c95,TWITTER,2024-09-28,STATIC_POST,3335,458,471,53,4317
7320d9e4-7bd2-4828-9745-173431a79c06,TWITTER,2024-01-31,VIDEO,3054,986,402,242,4684
45f80d77-2951-4d55-918c-860b99d37871,LINKEDIN,2024-10-13,STATIC_POST,1960,72,11,273,2316
70df07f9-4493-462b-93dc-eca30917330a,YOUTUBE,2024-05-15,REELS,1121,224,184,1529
0d1aa499-f1b9-42e2-aa3e-91bd1c292b44,INSTAGRAM,2024-03-30,VIDEO,4865,900,345,6110
60d0ebec-a628-4d51-8c5a-379069bb5415,LINKEDIN,2024-06-08,TEXT,919,63,367,294,1643
10ed5d3f-7b38-41b4-a550-50f3a2f13d9b,YOUTUBE,2024-04-27,STATIC_POST,2031,743,368,3142
2f238625-4793-4d1a-a949-225757868548,TWITTER,2024-01-28,TEXT,1713,337,139,153,2342
c84f5641-89dd-4b23-ba0b-4ee75c849862,TWITTER,2024-12-31,TEXT,399,240,35,231,905
6d41a2b1-4f81-4c7c-ad41-73136993a42c,YOUTUBE,2024-07-22,VIDEO,1409,318,498,2225
64b162dc-f96b-4ac1-b297-0cd27d312beb,LINKEDIN,2024-08-21,REELS,233,655,33,53,974
e05cc7a6-f6e8-4d9c-a4dc-bd0fd795ba22,LINKEDIN,2024-06-24,TEXT,978,301,444,115,1838
c6d15c4f-2cf6-41d0-8612-31ab368a12ab,TWITTER,2024-06-29,STATIC_POST,4781,95,78,40,4994
01939b35-1d7c-4ac6-a6d4-b8793ae68dc5,TWITTER,2024-02-21,VIDEO,2846,218,106,247,3417
8b066b9f-e96a-47e1-bd98-e4426bef2c95,INSTAGRAM,2024-08-17,CAROUSEL,2390,137,372,2899
2b45f4a7-2024-4ea0-9038-cfb9b6075725,LINKEDIN,2024-11-29,TEXT,4053,893,168,198,5312
cd4e1dbb-a7da-443a-8c12-d787d9fe7f2a,YOUTUBE,2024-05-23,REELS,958,302,34,1294
13fde485-cb01-4ce8-b95c-c860647d816e,TWITTER,2024-04-04,VIDEO,1269,860,192,206,2527
0e1e9ebf-0cb3-40b7-b752-066a224577e0,LINKEDIN,2024-01-21,REELS,4534,613,86,271,5504
5fccf7aa-86b0-4dce-9fef-2497e57d4045,INSTAGRAM,2024-08-09,REELS,809,137,396,1342
4d5c1004-94eb-4f44-958e-efa4ef0bff68,YOUTUBE,2024-10-18,TEXT,4485,253,197,4935
03761d52-26a8-4dd9-b7de-4809fc6d7080,LINKEDIN,2024-11-09,REELS,1415,889,3,161,2468
3541b05f-6bb3-4d0b-9912-0a852343f85d,TWITTER,2024-06-09,TEXT,4443,10,275,259,4987
9da28db1-b04d-47f1-912e-7e10979fc4c1,YOUTUBE,2024-11-21,STATIC_POST,3756,420,25,4201
df1ae32f-4a0b-43bf-9d51-bae880d80a08,LINKEDIN,2024-08-12,TEXT,3062,417,366,268,4113
130e97a5-d05a-4c17-aee8-8c142517eeaf,INSTAGRAM,2024-04-14,STATIC_POST,2139,493,307,2939
485e085c-0923-42ed-8ef0-00b210bffce2,YOUTUBE,2024-05-11,VIDEO,2877,736,247,3860
4f32d8fb-7231-4fdf-b72d-3bb6427f1f0e,TWITTER,2024-03-12,VIDEO,2231,868,474,220,3793
2dcb4497-6749-49b2-81bd-c865b3f31180,YOUTUBE,2024-08-20,VIDEO,3031,360,21,3412
801aed15-9e85-48c9-94c2-080884a91db1,INSTAGRAM,2024-07-14,STATIC_POST,2113,417,382,2912
2076c883-b7a6-4c28-a011-72cfa7068576,YOUTUBE,2024-12-09,TEXT,2636,359,184,3179
3b4b947e-2309-41de-a9c5-4af4a547c75b,YOUTUBE,2024-03-20,TEXT,1565,379,332,2276
eddf3a49-06c2-4680-978e-a03212036744,YOUTUBE,2024-03-09,REELS,60,953,236,1249
84e9d7ed-98fc-4994-be0b-b50bc38c4076,LINKEDIN,2024-02-20,REELS,2092,624,314,49,3079
4d3619d7-7ff6-446e-8d23-6e7d308c8b87,TWITTER,2024-05-05,STATIC_POST,2191,807,496,217,3711
87993505-c03d-44ed-8e74-47a8c5273138,LINKEDIN,2024-12-12,STATIC_POST,1431,715,348,231,2725
0764cacb-b0f0-4637-9008-f3c87e75d303,LINKEDIN,2024-12-04,TEXT,4113,610,421,78,5222
5ba0448f-9329-44fb-954d-8be8dcee711f,YOUTUBE,2024-03-08,TEXT,4136,718,239,5093
7acaa65a-0a19-4430-8cda-6163a02ad3ff,TWITTER,2024-05-08,STATIC_POST,1305,255,143,274,1977
69144e8c-e442-4d94-98b4-7528fab4205f,LINKEDIN,2024-01-08,TEXT,4636,818,177,289,5920
d81a09f1-a2ec-4cbb-8ce0-b871b8e9466f,TWITTER,2024-11-13,TEXT,802,169,77,272,1320
d5c3a6d7-a0f1-49f9-bdd4-b3cef780e721,YOUTUBE,2024-05-18,VIDEO,118,927,458,1503
87080667-e836-4f4f-ac4a-8e5aa2655e82,LINKEDIN,2024-02-13,STATIC_POST,58,579,392,284,1313
4ed9e22e-9150-442a-857e-32d9cc609599,YOUTUBE,2024-03-27,STATIC_POST,634,116,448,1198
cc1bdc88-a855-44a5-94e5-3309586e0f60,LINKEDIN,2024-08-15,TEXT,4064,5,445,196,4710
8d09a0a8-37ef-4caa-9098-9e463275b5b3,INSTAGRAM,2024-08-05,REELS,4380,933,38,5351
80b4608b-f67c-4f26-baae-df756c3fe34e,TWITTER,2024-03-19,VIDEO,1818,449,437,128,2832
5bc37bb6-a168-453e-9ab7-3a64690a5375,TWITTER,2024-09-07,VIDEO,4912,198,211,165,5486
db77da78-b2da-46ad-88ef-d0fa825e3999,INSTAGRAM,2024-08-11,REELS,2902,109,346,3357
1a1c228a-2141-4455-b411-036459e67bc9,LINKEDIN,2024-12-01,REELS,875,218,116,107,1316
46d5ad60-9816-4e0c-90a7-36267874cdab,LINKEDIN,2024-08-16,REELS,48,593,197,261,1099
da409562-30ff-4961-9028-05df7aecfc7a,INSTAGRAM,2024-02-17,REELS,3925,965,76,4966
c8fde74c-4bb6-44e2-8ae4-f73775db9cd3,TWITTER,2024-12-03,STATIC_POST,2033,1000,90,169,3292
fed79261-6442-483b-872f-b378a7481072,INSTAGRAM,2024-06-14,CAROUSEL,2836,200,302,3338
e27e1d05-924a-416d-82cf-f49dfc7c658d,TWITTER,2024-08-25,VIDEO,3357,944,39,290,4630
915a4b95-4a9d-45b4-a024-7c8510845241,YOUTUBE,2024-02-13,TEXT,2614,157,57,2828
874d8d7a-68c0-4bb4-b0a9-2dd9eb9e2a24,YOUTUBE,2024-05-18,VIDEO,60,301,291,652
9b5964cd-6828-4999-8c80-5723b03522e3,LINKEDIN,2024-07-31,STATIC_POST,4954,486,191,90,5721
41a553ac-f6d9-413b-8cdb-b5b8c0d16cc7,YOUTUBE,2024-12-26,VIDEO,3715,349,388,4452
db217258-e239-439e-bdf4-8a259cfad528,TWITTER,2024-11-25,TEXT,4514,874,380,214,5982
29e99987-e46b-4486-90d8-42a104dcb83f,INSTAGRAM,2024-08-31,REELS,3133,649,494,4276
afe39a5c-b211-48a4-860e-40f9b0d72599,TWITTER,2024-04-09,TEXT,472,612,148,260,1492
8074116d-d90d-497b-8ba4-3a04b51800d1,INSTAGRAM,2024-05-12,STATIC_POST,1561,732,94,2387
998fbe3f-3c37-4166-a717-35c0924cb5b7,LINKEDIN,2024-04-16,REELS,4417,994,357,286,6054
f226ed4e-e148-4ac1-af74-7db66f952220,TWITTER,2024-01-15,STATIC_POST,4213,449,344,45,5051
34d842e7-44bc-492e-bdfc-ff93b2f69127,LINKEDIN,2024-02-06,TEXT,946,134,363,8,1451
e2924b6f-851c-4e4f-ba1e-650c5f517caa,LINKEDIN,2024-06-21,STATIC_POST,1143,225,414,179,1961
61ac1cd3-95e5-4edc-9b47-65276cf5671e,LINKEDIN,2024-08-15,REELS,3449,670,381,80,4580
382ad7b4-f6f5-49e6-88df-4f31cf3864e3,INSTAGRAM,2024-06-14,STATIC_POST,4164,824,71,5059
9fe42f1c-74c3-4184-9a2c-5ae01c76d685,TWITTER,2024-02-12,STATIC_POST,3586,48,437,159,4230
8c119b9d-638c-4318-b967-e42ed0b3b7e2,INSTAGRAM,2024-03-18,REELS,49,634,288,971
0a2044c1-2a6c-4197-b122-b3f8bc575acf,INSTAGRAM,2024-09-27,REELS,1493,276,435,2204
509c6358-552d-4a28-b24e-3154b49859ea,TWITTER,2024-05-18,TEXT,3982,230,283,167,4662
00ff23b4-18c5-44d8-8a7b-f807b61899ca,INSTAGRAM,2024-05-02,REELS,734,797,313,1844
f9e9eff1-ff46-4155-b915-eb90efd254d0,TWITTER,2024-04-26,TEXT,523,866,370,54,1813
86513a0b-1889-4cf8-b479-1b13346d1d8c,TWITTER,2024-11-25,STATIC_POST,937,830,172,161,2100
56ceac7a-0faf-4612-9460-6e984f0e8c74,LINKEDIN,2024-12-31,TEXT,4555,35,97,3,4690
16806574-eecf-49d2-b396-b0988ed01a70,LINKEDIN,2024-05-21,STATIC_POST,15,66,339,147,567
3f0f5a96-4ae3-435b-9cca-412d8c5db0b3,TWITTER,2024-04-22,VIDEO,817,196,435,228,1676
8c9d45ad-a2a7-46d0-989e-11d5386ab5eb,INSTAGRAM,2024-02-20,VIDEO,3087,609,297,3993
1730e36e-d698-4a74-8ead-5876719d5b5f,INSTAGRAM,2024-10-01,CAROUSEL,3301,99,280,3680
43b1c10d-2028-4caf-882e-da97213897d0,TWITTER,2024-09-22,TEXT,71,587,152,249,1059
de5fd601-30ff-450b-9224-67b6f16596b2,LINKEDIN,2024-04-10,REELS,3258,932,398,186,4774
25dff378-c48e-40a0-83e7-f35d1ed9ff17,YOUTUBE,2024-12-02,STATIC_POST,1438,59,438,1935
88006833-f828-4a80-b4db-329edde0ffe5,LINKEDIN,2024-06-18,TEXT,3483,160,27,109,3779
3cc5e8e0-c092-48d3-99a3-f5ede34b3825,YOUTUBE,2024-03-19,VIDEO,1260,338,124,1722
0ac37712-2e3d-41a8-8a6c-f416429816ac,TWITTER,2024-08-11,VIDEO,643,504,41,126,1314
6c24fbc7-b4c4-41bc-9632-9e5f648f5672,YOUTUBE,2024-08-25,VIDEO,3576,145,228,3949
9a964322-4e23-4eb9-b683-57608ac94dd7,TWITTER,2024-03-30,TEXT,2965,595,42,211,3813
e0d26bff-5e13-4d59-b37c-ecc3405c898c,LINKEDIN,2024-07-27,STATIC_POST,4981,164,394,266,5805
0f709d2c-4591-4a31-99ca-8ff93cc59e33,INSTAGRAM,2024-02-08,VIDEO,3855,664,489,5008
87706db2-6e7d-4be5-b144-907de359d6ca,INSTAGRAM,2024-07-12,STATIC_POST,4297,519,152,4968
9008cc1c-495d-476a-bc95-768a55bffb73,TWITTER,2024-12-27,STATIC_POST,3380,297,269,25,3971
fe7a5bf3-8c69-44bf-afe6-573666c311dd,INSTAGRAM,2024-08-07,REELS,1128,368,213,1709
f52333e3-7d46-41eb-962c-604a6ce64329,LINKEDIN,2024-07-31,REELS,4251,340,204,220,5015
7bffc3a5-310b-44de-a8be-89d030c7d9ed,LINKEDIN,2024-11-14,REELS,1853,156,114,4,2127
6718b4c6-548a-4aa5-b5fd-117e1e265a57,YOUTUBE,2024-12-05,REELS,680,182,432,1294
46dfa189-6acd-492c-8814-33910199319f,TWITTER,2024-06-27,TEXT,332,78,414,92,916
0c3632fb-bfb8-48a6-8bfb-846aa8b0506f,LINKEDIN,2024-11-08,REELS,1477,356,431,177,2441
fcc6384d-3bc7-4b82-aed0-ad3849922286,YOUTUBE,2024-11-10,REELS,1539,731,64,2334
8685fda2-e911-4287-941b-4ec1f4f4efae,INSTAGRAM,2024-06-24,CAROUSEL,4385,560,240,5185
8958ed84-7812-4026-bf8b-99fb151268d9,TWITTER,2024-09-15,VIDEO,521,126,403,251,1301
75908b2d-075e-4335-85e0-790f5f374135,TWITTER,2024-10-25,TEXT,1202,525,437,49,2213
360a8d60-3528-495d-b6a9-079e3781c71a,YOUTUBE,2024-08-02,TEXT,2664,356,246,3266
ba7df071-b97d-4618-9d16-423a1eb7dd18,TWITTER,2024-04-14,TEXT,286,128,86,12,512
ea126f34-def3-47f0-b43d-2da11a0c2887,LINKEDIN,2024-10-09,TEXT,4253,124,408,160,4945
e180ce70-21de-46d6-b22d-77edf4f2fdaa,LINKEDIN,2024-08-25,REELS,4898,172,396,59,5525
2d1cdbe0-62ea-48f8-8b20-6193a9db94d5,YOUTUBE,2024-05-17,REELS,3566,325,353,4244
91092936-1e67-4a48-8340-51833b21354c,LINKEDIN,2024-05-26,REELS,2040,272,146,277,2735
375393fc-029c-4a1d-b35d-d47e3a4a76f0,INSTAGRAM,2024-03-15,CAROUSEL,4406,901,183,5490
3b1e0de3-ba36-4799-a6c9-963e98cea726,LINKEDIN,2024-05-01,TEXT,1800,698,217,8,2723
d73b8d09-64a5-4352-bec3-9fe7d9c98325,INSTAGRAM,2024-11-30,VIDEO,3329,9,371,3709
2c5f5da6-8d50-4b8c-83af-9314ad0760b2,LINKEDIN,2024-06-04,REELS,949,234,264,266,1713
ff239180-1f6e-4899-bab5-afc8d87b08bc,YOUTUBE,2024-04-30,STATIC_POST,1847,784,303,2934
316936e3-d3de-4e7e-a546-f5f9c56773bc,INSTAGRAM,2024-06-10,REELS,1437,981,115,2533
7823fb13-f364-4a72-92f1-5da2c720948c,INSTAGRAM,2024-02-07,REELS,1816,640,22,2478
6a45b688-5145-4044-8464-e6e1ef6b20a9,YOUTUBE,2024-12-14,TEXT,3709,13,34,3756
420ea33b-bd25-4600-a3bd-3e70dea30b5e,LINKEDIN,2024-12-30,REELS,469,317,493,222,1501
18d2f2a1-6302-4725-8530-51ccabb0949e,INSTAGRAM,2024-02-11,CAROUSEL,232,373,201,806
c4557c6a-9d14-45e1-b109-2fe08c85d365,TWITTER,2024-04-10,TEXT,1535,615,291,142,2583
7552eca0-d042-4cbf-998c-a0d510a3e35b,YOUTUBE,2025-01-03,VIDEO,1719,618,76,2413
2ef23891-455b-4ca7-9008-da5b94ba4679,TWITTER,2024-11-09,VIDEO,1644,350,9,105,2108
fdbdcc3e-11d4-4409-8bf3-684a6e4a99be,YOUTUBE,2024-01-23,STATIC_POST,1800,830,331,2961
0d2539af-3e5e-43c3-8de7-74c9dbc40113,LINKEDIN,2024-11-28,STATIC_POST,4811,933,307,129,6180
28be0dd4-1bec-409b-baa9-3823e56f8b47,INSTAGRAM,2024-12-22,STATIC_POST,3642,719,240,4601
83832514-5bf5-47d2-a310-4b94055a9780,TWITTER,2024-08-04,VIDEO,951,863,271,256,2341
2be59d83-9f74-4e28-b91d-0c5e96429855,INSTAGRAM,2024-11-02,VIDEO,4902,312,97,5311
09fb1a50-e805-49d0-b62b-ba88ecdeafa2,LINKEDIN,2024-11-17,REELS,4905,784,436,150,6275
b06ad960-2560-41ef-831e-fda68ffe58fd,YOUTUBE,2024-06-29,REELS,2078,745,291,3114
2462a020-5731-4ed8-a964-0553a180ad1a,TWITTER,2024-08-27,VIDEO,3110,828,283,145,4366
5c46adb4-5f6e-4e11-9759-ef8dfeebded3,TWITTER,2024-12-31,TEXT,531,366,51,52,1000
29abeb84-da0c-4acb-8ac8-ee6033902e36,YOUTUBE,2024-11-21,VIDEO,530,588,38,1156
0ed95d0b-0239-404a-802c-30cb6a46978c,TWITTER,2024-01-07,STATIC_POST,3496,414,228,225,4363
0cf0a3a4-8c4c-47bd-a69a-25e7a9a9420e,YOUTUBE,2024-11-06,TEXT,337,377,285,999
016cb876-d974-4d62-8387-9ebc73744951,YOUTUBE,2024-03-28,VIDEO,3794,782,180,4756
ecebbd67-fe0b-4225-b415-74b97525f9db,INSTAGRAM,2024-02-20,REELS,2858,962,482,4302
407e03f1-a061-48fd-b7ab-57a8edaab96d,LINKEDIN,2024-10-16,REELS,4218,716,369,214,5517
1101eb96-5d85-4742-95ec-f0f9aa317817,YOUTUBE,2024-12-30,VIDEO,1871,324,276,2471
83015728-93bb-4d03-b1a7-b5f6bc109707,LINKEDIN,2024-06-03,TEXT,1723,613,446,256,3038
505b1bc5-723e-4655-9e5b-ebae89c313de,LINKEDIN,2024-10-26,STATIC_POST,1478,595,260,13,2346
9a49db63-f669-4861-ad03-c7e2618a15f7,YOUTUBE,2024-02-20,STATIC_POST,1047,132,418,1597
bc431229-10c4-438e-9a7f-0799bccfb043,YOUTUBE,2024-02-21,REELS,662,668,52,1382
e10f85ed-1988-46fd-a96f-5d465a92adf7,YOUTUBE,2024-03-25,VIDEO,3492,937,496,4925
1e835003-79d1-4f00-8499-b3cd67c09ad2,INSTAGRAM,2024-09-27,VIDEO,1550,738,101,2389
266c57ec-44c8-46ee-86a2-deac03c99bdb,TWITTER,2024-12-23,TEXT,2000,809,251,295,3355
408641a7-f9ea-4c91-8e17-bdc50efe57a3,TWITTER,2024-11-30,VIDEO,3716,846,486,210,5258
95bc3126-31dc-4263-b8a0-59e9692ca9ba,YOUTUBE,2024-05-02,REELS,2715,261,78,3054
4d037586-6e26-414a-96b3-493d4d25feb2,YOUTUBE,2024-07-17,VIDEO,4603,635,263,5501
549f2998-c2a2-4b00-9e47-e97d0be905fa,LINKEDIN,2024-03-18,STATIC_POST,4699,47,310,40,5096
c6668def-f7d9-4762-b90e-187105eee4bb,INSTAGRAM,2024-12-27,STATIC_POST,4402,319,213,4934
64a2e4a3-3d38-49c9-9f3f-1806f006c448,INSTAGRAM,2024-03-30,STATIC_POST,2404,514,404,3322
ca863a65-1863-4639-84e1-0ccba550c668,TWITTER,2024-01-23,STATIC_POST,323,210,162,133,828
24e53dc6-d9c5-4bd7-809c-d95c64e4a81d,TWITTER,2024-05-10,STATIC_POST,4410,338,118,223,5089
eed0052b-57fa-48e0-a1fc-9bbe6ae5173d,INSTAGRAM,2024-02-07,CAROUSEL,1429,741,20,2190
4da374f6-c0f6-4e82-bcbb-d8b18fe93f1f,INSTAGRAM,2024-02-07,STATIC_POST,529,989,52,1570
6db205fd-3865-43ce-b175-7ed9171a8750,LINKEDIN,2025-01-04,REELS,3027,313,101,267,3708
267e8716-b664-495b-bca0-7471f3bb9b60,LINKEDIN,2024-07-12,REELS,1102,50,225,299,1676
ff1cf69a-f62a-43e4-96a8-8d4e38590d8d,YOUTUBE,2024-12-17,TEXT,1431,590,455,2476
b9420585-7151-493b-9f46-0a14142ba4c4,INSTAGRAM,2024-09-17,VIDEO,2519,181,137,2837
60ddb3c8-6440-4e73-86cc-995fcfa72d02,INSTAGRAM,2024-03-19,STATIC_POST,3459,139,13,3611
316d2c42-6b3a-4da0-ae60-8da02c3ffea2,LINKEDIN,2024-04-26,REELS,2719,43,389,187,3338
be5fc91f-7261-4d5b-b87b-35fe193b6caf,INSTAGRAM,2024-08-10,STATIC_POST,1635,262,76,1973
c84c2367-d4e0-41fc-a10d-e3760782be52,INSTAGRAM,2024-11-21,STATIC_POST,1484,466,353,2303
9e4313bd-78a1-4c98-9d75-465fe862a115,TWITTER,2024-01-24,VIDEO,3490,341,134,56,4021
28ab9fd0-9aa2-4ecc-8cdf-fe1f5bfb037c,LINKEDIN,2024-12-11,TEXT,2353,114,241,166,2874
f0f4bbd4-c3b9-4659-bcec-89aa31ef391e,YOUTUBE,2024-05-11,STATIC_POST,3560,812,454,4826
65975983-a723-44ca-ba45-99ad542e5054,TWITTER,2024-10-13,STATIC_POST,2033,984,109,35,3161
31dd3c0a-9bdb-48f1-b4c8-d9ecefbf309f,LINKEDIN,2024-11-15,STATIC_POST,142,257,401,127,927
0329a71e-162b-4a9f-a876-658e8b3ff721,INSTAGRAM,2024-02-07,CAROUSEL,4532,753,413,5698
b5f94a88-1857-4566-a0a2-72f6cce4e4fc,LINKEDIN,2024-05-09,TEXT,3930,509,230,59,4728
5a56246a-9a62-4e2a-a40e-26c39cf81d36,YOUTUBE,2024-04-10,VIDEO,3719,409,367,4495
d6a16299-da6c-4418-a5ba-d4737acb3229,TWITTER,2024-03-22,STATIC_POST,3354,795,478,246,4873
94b88fff-e683-401e-9e97-ac6635d4e008,TWITTER,2024-11-30,STATIC_POST,4495,633,6,231,5365
4102fd6d-ddaf-4462-b05b-826451204bbc,INSTAGRAM,2024-12-20,VIDEO,3732,746,150,4628
17733ff4-3348-4c7f-9560-b0b9bfc736fc,YOUTUBE,2024-09-15,TEXT,4971,852,453,6276
417cc55d-01cd-4139-b209-1b3b8b9856fc,YOUTUBE,2024-10-26,REELS,1637,916,342,2895
1971480f-9405-4ffb-ad7b-feaf07e6c077,INSTAGRAM,2024-03-20,VIDEO,1832,485,253,2570
e660274d-63c1-4cbc-9626-4682f5a8826a,YOUTUBE,2024-02-11,TEXT,384,531,490,1405
b8931d31-5f0b-425b-ab87-8264a1d20cc0,LINKEDIN,2024-02-20,STATIC_POST,4167,702,166,94,5129
a767a6da-8681-42d8-9914-62cfe37f6f88,YOUTUBE,2024-06-20,REELS,668,626,293,1587
52133f31-9e16-4d04-9513-b9cf2cec19cf,INSTAGRAM,2024-07-26,CAROUSEL,3821,802,66,4689
ddc65f69-ce62-4d8d-9dad-dc91b0561079,LINKEDIN,2024-07-25,STATIC_POST,2436,323,432,233,3424
a145312b-0629-4893-a8c0-9dd62f14e1ab,INSTAGRAM,2024-04-21,STATIC_POST,3552,93,246,3891
c68d6793-52ab-449b-939d-e26e5fb20556,YOUTUBE,2024-11-25,TEXT,1351,6,343,1700
ccc6cd01-465a-4a2f-a66a-60f990e57b9f,TWITTER,2024-11-27,STATIC_POST,94,386,85,15,580
ca3afed5-a296-4781-97fb-bf8d329e5975,TWITTER,2024-11-24,TEXT,151,185,215,226,777
76dc4758-1311-4b24-a3c8-4b59edc040db,TWITTER,2024-09-12,VIDEO,2656,355,440,21,3472
0bfda8c0-1607-4f5a-9c5b-349bd1a77aac,INSTAGRAM,2024-03-17,REELS,575,867,206,1648
0fd0fb73-5101-40bb-a3ae-97c73cd50a55,YOUTUBE,2024-07-24,TEXT,2900,26,424,3350
34d3bcc7-f824-4682-ba50-6a259555c943,INSTAGRAM,2024-06-27,VIDEO,1242,962,354,2558
3d475f3e-0f5a-482a-85b8-76d028f44510,LINKEDIN,2024-10-10,STATIC_POST,3272,279,360,56,3967
2178f519-37a5-4875-8b8e-1e15cdfa1299,INSTAGRAM,2024-02-04,VIDEO,138,955,44,1137
1de4786b-6a1d-4733-94e6-0df6877bb029,LINKEDIN,2024-04-16,REELS,368,521,325,22,1236
2b8555ad-15d4-4923-a2e6-0344feae7ec6,INSTAGRAM,2024-04-06,STATIC_POST,2824,354,48,3226
f73d622c-7574-4e9c-9cbd-fb0964df1148,TWITTER,2024-03-18,TEXT,2027,440,218,210,2895
2112bd44-d42c-4e06-bdd7-25acf5d5b232,TWITTER,2024-04-15,TEXT,4805,349,432,225,5811
4fc1ccdb-5778-4203-b908-298d688fb671,YOUTUBE,2024-08-03,TEXT,3199,482,434,4115
97fc0d9f-0079-4803-b6e6-5495186acf24,LINKEDIN,2024-09-01,REELS,350,833,235,87,1505
ee5f880f-1567-465c-945e-c9fb0f16696e,INSTAGRAM,2024-11-02,CAROUSEL,1083,793,278,2154
e62c455b-e809-4ae7-8f9b-323275c8b1c0,INSTAGRAM,2024-03-27,STATIC_POST,3421,817,167,4405
5d526dac-6482-4809-ba8c-7cbd4cf5cc0f,TWITTER,2024-06-05,STATIC_POST,3430,600,139,23,4192
4c64d8eb-172a-4298-8f8e-6c46e2f58b74,TWITTER,2024-10-08,TEXT,1784,207,49,136,2176
c91c1f4b-a92c-4b3a-a929-70fe927345fd,LINKEDIN,2024-06-13,REELS,846,602,462,144,2054
1fca67d9-3895-4b1f-9427-04a40763216f,TWITTER,2024-05-16,VIDEO,4844,881,433,136,6294
14923539-fb39-4ba5-99c8-2536f83f0af1,TWITTER,2024-07-31,TEXT,175,782,304,238,1499
f9bbac63-a236-4449-9f36-5cec97ea3e67,LINKEDIN,2024-11-24,REELS,1522,274,136,60,1992
34420a69-4ce4-49e4-a5ef-4c486d917b82,INSTAGRAM,2024-05-14,VIDEO,1162,347,251,1760
f65dd2e0-9000-430f-aa55-a216342a6bc3,TWITTER,2024-12-05,TEXT,1452,807,389,227,2875
da354820-0cb3-4d47-9e03-aa1843260106,LINKEDIN,2024-02-08,REELS,4239,28,293,280,4840
ed665465-caad-4e18-982b-a58929e754bb,LINKEDIN,2024-08-10,TEXT,4852,814,53,192,5911
1382afa2-4336-49dc-8d97-40c88863df05,INSTAGRAM,2024-11-19,CAROUSEL,3803,433,165,4401
af0c40f5-1ecd-46d6-8579-11fd692a194f,YOUTUBE,2024-08-26,REELS,589,916,103,1608
9858e182-5365-4588-86ac-a89b1b53c261,TWITTER,2024-06-11,STATIC_POST,3610,34,285,281,4210
324dcc2e-9bfb-423b-b4d4-4074763d8636,INSTAGRAM,2024-06-16,REELS,2213,86,399,2698
a51a9bff-9b99-48c2-8127-2489a45e33e5,YOUTUBE,2024-03-09,REELS,310,278,284,872
cf5273f5-95d9-4b63-955e-d2db28bee22a,TWITTER,2024-04-01,TEXT,2222,784,471,83,3560
0cfea46c-c39a-470b-b75e-1a5fe7084aaa,LINKEDIN,2024-03-23,REELS,882,381,239,48,1550
ada5284f-3dc4-482f-9ff6-18bdc54a57fa,LINKEDIN,2024-10-29,REELS,3337,887,120,155,4499
c8d3aab9-a3c8-42cc-a8f2-c3e5c248d2ad,LINKEDIN,2024-08-20,REELS,3173,772,358,230,4533
dbf32ebb-0343-4f7b-a0fb-8ecc8f1d553e,YOUTUBE,2024-12-11,REELS,208,181,308,697
2201f445-0de6-4b0e-84b4-d13d8bffffb3,LINKEDIN,2024-03-31,STATIC_POST,1788,383,209,229,2609
ace2dacc-bc34-45bd-8612-58f546681571,YOUTUBE,2024-10-26,STATIC_POST,2069,459,191,2719
05261e39-a283-4d59-9f3e-08ffe78a2e66,YOUTUBE,2024-07-22,REELS,1224,255,124,1603
3092e970-a229-4cab-bb33-c2cc4348e103,TWITTER,2024-12-28,VIDEO,1238,199,202,107,1746
c71c662f-47f0-4ad1-bfbb-47d40b62c54b,TWITTER,2024-11-18,STATIC_POST,1745,426,45,201,2417
1d07388c-f4d3-453b-aab5-fd9ef655436c,YOUTUBE,2024-04-06,REELS,1887,229,297,2413
9aac386b-c590-4ab7-a8a4-059ccfbc8781,INSTAGRAM,2024-01-14,VIDEO,2911,175,3,3089
984d2ea9-3f9a-4e06-990e-66648af9b2c0,INSTAGRAM,2024-08-07,STATIC_POST,4353,35,305,4693
a2cbac48-d2ee-43f4-8c02-685010327aa4,LINKEDIN,2024-02-16,TEXT,4315,21,480,79,4895
4923fd91-8b1e-4877-bfba-201d18244d8b,LINKEDIN,2024-05-12,TEXT,3832,262,499,59,4652
b5d88f08-dd84-4714-abd8-0ed771196f14,YOUTUBE,2024-03-25,TEXT,3737,927,268,4932
8a7b9dbe-b85e-44c7-982c-9c0eefc3150a,INSTAGRAM,2024-07-22,CAROUSEL,3915,112,448,4475
6d7159ed-fd11-4ef9-924f-1c6e4ddcca6d,INSTAGRAM,2024-03-26,CAROUSEL,2435,276,250,2961
dfa2a05d-952d-4663-9db9-00a7da452974,LINKEDIN,2024-12-22,TEXT,4809,512,319,47,5687
dcf34295-c9ec-4a19-a93b-10339fff3691,TWITTER,2024-08-27,VIDEO,3377,354,497,276,4504
c7166a39-3e6f-45d6-b6c2-c30d39b9a671,INSTAGRAM,2024-08-13,STATIC_POST,2232,743,154,3129
74187771-927b-4db4-8521-f7ca6b014c5f,LINKEDIN,2024-03-16,STATIC_POST,1247,752,442,257,2698
d705e2fa-1a2f-4c1e-af1d-351fb530018e,YOUTUBE,2024-03-05,REELS,515,30,140,685
e207a114-f3af-4283-a111-01131ab4d57c,YOUTUBE,2024-05-10,REELS,1409,553,61,2023
ea1ab23a-e880-47f0-aa51-7d1c9f145408,TWITTER,2024-10-31,STATIC_POST,2683,503,281,114,3581
e8b6b376-db0c-427a-b6a7-6349b3a0b5b8,INSTAGRAM,2024-09-16,CAROUSEL,968,143,379,1490
16f0c7c0-cadb-4a82-9d77-839c9156cac8,LINKEDIN,2024-04-09,REELS,3423,483,457,178,4541
099303e6-823d-46d9-98d2-9faa2edf7e62,LINKEDIN,2024-08-01,TEXT,1354,256,356,278,2244
e2bc69cd-edb3-493b-96c8-bd6997ae35db,YOUTUBE,2024-07-15,VIDEO,3740,218,202,4160
f3b99cfe-06f4-4d78-a1b0-5d0d07dc96a9,YOUTUBE,2024-01-27,STATIC_POST,1523,20,500,2043
6d01e0a0-1be8-4e77-bb80-1444c0574566,YOUTUBE,2024-01-30,VIDEO,2230,503,302,3035
7b78aca0-1e3e-419e-bbbc-de1c94cc3f9a,YOUTUBE,2024-03-09,STATIC_POST,63,763,28,854
872b7d4a-3423-452a-a90f-247213d801bc,TWITTER,2024-07-31,TEXT,1317,29,317,210,1873
a075976f-63a4-4a53-9583-12c340767ac3,INSTAGRAM,2024-08-04,VIDEO,2649,623,220,3492
976020a1-0f72-49f6-a206-a6b46d806554,YOUTUBE,2024-08-24,VIDEO,712,717,353,1782
3dcd1357-694c-4986-bd18-eee94e64a930,YOUTUBE,2024-02-20,STATIC_POST,3026,48,291,3365
e859e9e4-75de-4299-9c1d-50165e2889bf,YOUTUBE,2024-08-10,REELS,4226,832,175,5233
b228f1e6-8cbf-4db8-a51b-9f35a22108da,YOUTUBE,2024-06-07,STATIC_POST,958,728,157,1843
72899c05-f007-4f09-afff-ea2123590687,TWITTER,2024-02-12,VIDEO,4567,284,425,54,5330
1053f863-8bf1-437e-9259-598da9998324,INSTAGRAM,2024-04-13,STATIC_POST,1352,562,164,2078
6f8fe501-8e86-4bc7-9c2c-bd83f53a4dbe,LINKEDIN,2024-06-22,REELS,1078,908,469,206,2661
cd0a24f2-53a2-4989-93a4-d02b86beaee0,INSTAGRAM,2024-03-14,VIDEO,110,412,154,676
5a360f89-f5a8-460f-8129-011e1c2ea4b3,LINKEDIN,2024-10-26,STATIC_POST,1554,857,116,171,2698
639c5447-5ffb-4b56-88e0-1deb2412830b,INSTAGRAM,2024-09-20,VIDEO,762,427,337,1526
1fa13c1d-a319-414b-86ee-bc5eb7632089,YOUTUBE,2024-12-20,REELS,3833,867,13,4713
e2f98c69-33b5-4c5b-9c19-5980bc79b408,INSTAGRAM,2024-10-18,REELS,3345,147,160,3652
19870da2-dc99-489d-9055-4e286c7713b6,YOUTUBE,2024-04-08,STATIC_POST,1361,56,253,1670
1d73edee-69a2-421e-905d-e3d65be6ba54,INSTAGRAM,2024-01-24,VIDEO,1363,749,14,2126
4d85226b-ea46-4a38-b120-6f493cf2ecae,INSTAGRAM,2024-12-08,VIDEO,4875,166,112,5153
1fc5ae47-f0d0-4bee-85db-b7506141dbcd,YOUTUBE,2024-02-11,TEXT,4993,239,399,5631
4e053871-4dad-4e44-b2a0-856bf56f8049,LINKEDIN,2024-06-01,STATIC_POST,410,653,316,129,1508
532ae87a-c625-4872-b55f-23009c30e37a,LINKEDIN,2024-12-06,STATIC_POST,4350,398,237,149,5134
e5fdd415-d98a-4ff1-96c1-35e6af5b609f,YOUTUBE,2024-06-24,STATIC_POST,243,165,423,831
000ad1b1-9ee8-49ba-9f5c-f6e7922161f3,INSTAGRAM,2024-06-27,VIDEO,1102,729,373,2204
507e902f-dc59-4f4b-a028-67600c088716,LINKEDIN,2024-05-11,TEXT,1474,845,471,118,2908
787ad645-2ea0-497c-8383-fef289d057e2,INSTAGRAM,2024-10-28,CAROUSEL,3083,205,425,3713
ae036105-0cb2-4875-8ccb-63754536ccfa,YOUTUBE,2024-05-29,VIDEO,4113,149,358,4620
73354729-7310-408f-b5d8-7f02e7f790d6,TWITTER,2024-06-11,TEXT,2396,788,155,179,3518
fb39b7b8-4f87-4abd-93e1-995da24ca165,YOUTUBE,2024-12-14,TEXT,1474,710,356,2540
facfa986-8939-47b8-abc1-1b83c606d996,TWITTER,2024-05-20,STATIC_POST,173,959,445,211,1788
c08779ca-e800-47a3-9393-25d28d0c8e57,YOUTUBE,2024-06-14,STATIC_POST,1411,932,192,2535
bbe09866-a04b-425b-bd51-940eb7fcb3d4,INSTAGRAM,2024-08-16,REELS,1573,783,134,2490
2093bc06-babe-4f66-9137-bcd4831fbb6e,YOUTUBE,2024-04-13,REELS,1859,131,33,2023
fa313199-778f-4d5d-9c94-0197696382db,LINKEDIN,2024-03-31,STATIC_POST,3917,35,415,202,4569
2a66a8e7-f78f-417b-a150-29f2cd10d01f,INSTAGRAM,2024-04-24,REELS,971,642,441,2054
aa401d08-79d2-42c7-8391-9054a4d5aa40,INSTAGRAM,2025-01-02,REELS,2649,99,373,3121
ff89749a-74a0-413b-938c-1312ae8b80db,LINKEDIN,2024-12-09,STATIC_POST,4043,771,25,241,5080
c8decd36-fd23-44a1-8d72-52622b59fdca,TWITTER,2024-04-09,STATIC_POST,2953,949,292,139,4333
ce5f80f3-cd66-4340-a049-675e03461f7b,LINKEDIN,2024-07-16,REELS,712,407,235,242,1596
d867b388-109d-4496-a144-4ea1a1378cd3,TWITTER,2024-06-02,VIDEO,4617,553,301,242,5713
52bbca5e-d155-44e1-9eb0-940874e57084,LINKEDIN,2024-07-14,STATIC_POST,3059,161,336,38,3594
c16c4e96-2b12-4675-bef2-7f000d0391a2,YOUTUBE,2024-01-10,REELS,1100,193,79,1372
16f4c658-b20c-4393-a61b-3383ffd19ed7,YOUTUBE,2024-08-07,REELS,929,633,428,1990
92377051-6bf9-49f6-b23e-62724e00b085,INSTAGRAM,2024-01-27,STATIC_POST,1717,530,378,2625
190520bc-91bc-410d-b1b1-b1d584e373aa,TWITTER,2024-01-28,STATIC_POST,58,970,446,192,1666
f9c6c553-4eb5-4973-91ae-9cf7afcadab1,YOUTUBE,2024-07-15,TEXT,1347,552,181,2080
2365c218-d959-4616-bbc9-3d4b591c5249,TWITTER,2024-09-14,STATIC_POST,4998,641,310,173,6122
95cf1ece-c8c0-4d67-9302-b5f6e0100fb9,LINKEDIN,2024-06-23,STATIC_POST,4619,695,110,289,5713
b1c9ad63-5d50-4ab1-9b7b-2f6f98f0bbb5,YOUTUBE,2024-12-04,STATIC_POST,425,58,209,692
a5863618-48a4-44c1-85ef-8689f15e110e,YOUTUBE,2024-01-22,TEXT,1105,445,392,1942
97f11b52-1771-47ae-85bc-bc23e8ad42b5,YOUTUBE,2024-12-01,TEXT,2773,565,381,3719
0b4e0511-2d42-4227-8995-7516203483b6,LINKEDIN,2024-01-19,TEXT,4086,874,18,121,5099
c87720a7-faaa-4d80-a414-d7b0fdcf383f,YOUTUBE,2024-01-14,STATIC_POST,1990,847,229,3066
3490d3e2-18b1-4110-ba2f-30475cff8ec7,LINKEDIN,2024-08-30,STATIC_POST,2720,107,459,25,3311
