ID,DATE,MEDIATYPE,LIKES,SHARE,COMMENTS,ENGAGEMENT
433fc052-f6aa-4e80-b494-d1a19a7916c0,2024-05-07,TEXT,3254,904,313,4471
3b4b947e-2309-41de-a9c5-4af4a547c75b,2024-03-20,TEXT,1565,379,332,2276
a410d45d-b76d-47fa-b1ad-18715e85e57f,2024-11-24,TEXT,4086,996,198,5280
fcc6384d-3bc7-4b82-aed0-ad3849922286,2024-11-10,REELS,1539,731,64,2334
94641e3d-0382-42ff-8fae-0ef5bc0c641a,2024-09-13,TEXT,3808,146,121,4075
00a5cf97-79c4-4722-a91f-264cc2e9d8d8,2024-04-30,TEXT,3909,436,256,4601
53cd0b33-9aad-48be-8be4-e4f0c4037458,2024-05-17,REELS,3015,34,132,3181
fdbdcc3e-11d4-4409-8bf3-684a6e4a99be,2024-01-23,STATIC_POST,1800,830,331,2961
e9d1b665-c8e1-42e5-8af6-eb93659eabcd,2024-04-26,REELS,2602,173,3,2778
93cac00f-4b43-4cae-b88a-d20946c03c87,2024-06-06,REELS,3769,498,22,4289
960b7705-4978-43c0-b529-5ce07eab728e,2024-09-20,VIDEO,4900,280,395,5575
278c8147-04c2-47a0-8175-2216bd0654ab,2024-09-19,STATIC_POST,4143,665,115,4923
e859e9e4-75de-4299-9c1d-50165e2889bf,2024-08-10,REELS,4226,832,175,5233
cd4e1dbb-a7da-443a-8c12-d787d9fe7f2a,2024-05-23,REELS,958,302,34,1294
c892b6d7-d165-477f-9320-997d69cf86c5,2024-12-22,STATIC_POST,849,355,354,1558
c08779ca-e800-47a3-9393-25d28d0c8e57,2024-06-14,STATIC_POST,1411,932,192,2535
709b89af-ecec-4abc-8a92-9e9c8839c7dd,2024-06-02,TEXT,3419,895,248,4562
29abeb84-da0c-4acb-8ac8-ee6033902e36,2024-11-21,VIDEO,530,588,38,1156
c293e303-94ab-43fb-8f99-4d3b593d1972,2025-01-02,REELS,4039,617,225,4881
88520705-013d-4fee-b5f3-69fa4961e20e,2024-06-13,TEXT,3096,546,70,3712
fb39b7b8-4f87-4abd-93e1-995da24ca165,2024-12-14,TEXT,1474,710,356,2540
19870da2-dc99-489d-9055-4e286c7713b6,2024-04-08,STATIC_POST,1361,56,253,1670
fed15d43-bbc6-49ab-a469-cddf9649d6c5,2024-06-01,TEXT,543,73,294,910
1177744d-e811-4bd1-909b-4265a97163a4,2024-07-13,VIDEO,4980,282,405,5667
944ab130-e364-475a-a475-f2e1e573bc54,2024-02-11,VIDEO,3112,761,301,4174
c87720a7-faaa-4d80-a414-d7b0fdcf383f,2024-01-14,STATIC_POST,1990,847,229,3066
c9069541-25aa-4aa9-9ed4-c8bf4663e9f8,2024-11-10,TEXT,2751,369,21,3141
95bc3126-31dc-4263-b8a0-59e9692ca9ba,2024-05-02,REELS,2715,261,78,3054
5cf3528c-d736-4a65-878c-67d31b0c7f62,2024-05-10,VIDEO,1905,488,471,2864
2dcb4497-6749-49b2-81bd-c865b3f31180,2024-08-20,VIDEO,3031,360,21,3412
f15f2cd4-d913-4345-bb55-b9b8571a9e91,2024-05-17,VIDEO,961,592,447,2000
6d01e0a0-1be8-4e77-bb80-1444c0574566,2024-01-30,VIDEO,2230,503,302,3035
a93dd995-1fd0-4aa2-9399-a01ddcd61575,2024-11-30,REELS,367,52,438,857
9f57d354-3f49-48d9-84f5-7be0fe0fe14d,2024-04-14,TEXT,4131,962,382,5475
e207a114-f3af-4283-a111-01131ab4d57c,2024-05-10,REELS,1409,553,61,2023
8be07cfd-f681-4bd7-bdc3-95bd17b28a11,2024-08-04,STATIC_POST,987,761,116,1864
417cc55d-01cd-4139-b209-1b3b8b9856fc,2024-10-26,REELS,1637,916,342,2895
b684a917-8956-432d-8da1-60845ff7a2a1,2024-08-05,TEXT,3888,346,115,4349
ace2dacc-bc34-45bd-8612-58f546681571,2024-10-26,STATIC_POST,2069,459,191,2719
5d68928b-d049-454a-98c9-fc7eb61cd817,2024-04-26,TEXT,807,912,393,2112
d3fc4425-9ce1-496e-8afd-703270883fb1,2024-11-12,VIDEO,4048,308,441,4797
a390a8f8-7e1e-4837-a02c-7f0aa55347a2,2024-04-05,VIDEO,3687,525,400,4612
6d41a2b1-4f81-4c7c-ad41-73136993a42c,2024-07-22,VIDEO,1409,318,498,2225
a5041d59-4520-463d-86cb-d662679a6468,2024-07-26,VIDEO,854,266,474,1594
360a8d60-3528-495d-b6a9-079e3781c71a,2024-08-02,TEXT,2664,356,246,3266
7552eca0-d042-4cbf-998c-a0d510a3e35b,2025-01-03,VIDEO,1719,618,76,2413
78c35314-c895-4f92-b79f-af94466cb393,2024-08-31,TEXT,3686,427,187,4300
f0f4bbd4-c3b9-4659-bcec-89aa31ef391e,2024-05-11,STATIC_POST,3560,812,454,4826
05261e39-a283-4d59-9f3e-08ffe78a2e66,2024-07-22,REELS,1224,255,124,1603
c722bbcf-184f-4fc8-9a9e-0091f3ffa171,2024-07-14,TEXT,3914,830,17,4761
e5fdd415-d98a-4ff1-96c1-35e6af5b609f,2024-06-24,STATIC_POST,243,165,423,831
53ca6791-ca5f-4889-8e13-7489c1869397,2024-07-16,REELS,4117,564,475,5156
7b78aca0-1e3e-419e-bbbc-de1c94cc3f9a,2024-03-09,STATIC_POST,63,763,28,854
7669f39f-7b20-4c0a-8c4b-13ca2826da29,2024-08-12,STATIC_POST,1996,656,56,2708
920e4cd4-afab-4240-91d0-41c99ee6947b,2024-10-07,TEXT,1435,629,22,2086
7cc2d7e8-bcb2-443c-a911-cbdd76bc48b7,2024-02-23,TEXT,1329,71,420,1820
c68d6793-52ab-449b-939d-e26e5fb20556,2024-11-25,TEXT,1351,6,343,1700
4dee6b60-6662-4bbf-b733-89ff5b969165,2024-06-10,STATIC_POST,4304,185,217,4706
05443be4-8f6a-496b-b91e-c5a71db57664,2024-02-04,REELS,4656,49,351,5056
ae036105-0cb2-4875-8ccb-63754536ccfa,2024-05-29,VIDEO,4113,149,358,4620
c16c4e96-2b12-4675-bef2-7f000d0391a2,2024-01-10,REELS,1100,193,79,1372
05404a1f-e76a-45b5-8c7f-22e8f68fe172,2024-10-17,STATIC_POST,1084,378,292,1754
b5d88f08-dd84-4714-abd8-0ed771196f14,2024-03-25,TEXT,3737,927,268,4932
485e085c-0923-42ed-8ef0-00b210bffce2,2024-05-11,VIDEO,2877,736,247,3860
45bd5f98-7ef8-403d-a7f1-cefbd30a354f,2024-04-22,TEXT,75,558,212,845
bf430652-1a73-42ec-a8f1-cd2fe7ece130,2024-08-17,REELS,3921,329,471,4721
e10f85ed-1988-46fd-a96f-5d465a92adf7,2024-03-25,VIDEO,3492,937,496,4925
26fa99aa-d7cd-4789-8394-d92e719ee0e6,2024-10-04,STATIC_POST,4574,924,133,5631
41a553ac-f6d9-413b-8cdb-b5b8c0d16cc7,2024-12-26,VIDEO,3715,349,388,4452
976020a1-0f72-49f6-a206-a6b46d806554,2024-08-24,VIDEO,712,717,353,1782
e2ba1fdb-283a-4a8e-871b-3aba8ba9f65e,2024-07-30,STATIC_POST,2038,483,322,2843
a767a6da-8681-42d8-9914-62cfe37f6f88,2024-06-20,REELS,668,626,293,1587
25a0fad8-7ee4-48f8-be93-8ff421f790f8,2024-06-28,VIDEO,1910,271,373,2554
70df07f9-4493-462b-93dc-eca30917330a,2024-05-15,REELS,1121,224,184,1529
4d5c1004-94eb-4f44-958e-efa4ef0bff68,2024-10-18,TEXT,4485,253,197,4935
fd8cac79-38d4-4480-9071-06ec17a3b1fd,2024-07-23,STATIC_POST,731,431,305,1467
c414d19e-dbd4-4a92-8c7f-fb63c51f7f87,2024-05-10,REELS,3967,614,291,4872
3dcd1357-694c-4986-bd18-eee94e64a930,2024-02-20,STATIC_POST,3026,48,291,3365
b2c43b98-5dd4-40b6-8b36-dbc7b5f01440,2024-08-09,REELS,2275,803,440,3518
b228f1e6-8cbf-4db8-a51b-9f35a22108da,2024-06-07,STATIC_POST,958,728,157,1843
8ee51b2b-8466-4963-81d5-e730ca2e0efb,2024-02-23,TEXT,769,420,68,1257
3cc5e8e0-c092-48d3-99a3-f5ede34b3825,2024-03-19,VIDEO,1260,338,124,1722
016cb876-d974-4d62-8387-9ebc73744951,2024-03-28,VIDEO,3794,782,180,4756
d05338c2-4ea4-4c1f-9ae3-a5e5f3cf2751,2024-03-04,REELS,3090,465,224,3779
4ed9e22e-9150-442a-857e-32d9cc609599,2024-03-27,STATIC_POST,634,116,448,1198
f3b99cfe-06f4-4d78-a1b0-5d0d07dc96a9,2024-01-27,STATIC_POST,1523,20,500,2043
3093d398-c74f-4762-8fa6-d03270f1b4a3,2024-09-26,REELS,4309,583,389,5281
5cd3e4c5-a4ab-4d2e-a613-af1b91a87000,2024-07-13,STATIC_POST,420,112,393,925
2d1cdbe0-62ea-48f8-8b20-6193a9db94d5,2024-05-17,REELS,3566,325,353,4244
4fc1ccdb-5778-4203-b908-298d688fb671,2024-08-03,TEXT,3199,482,434,4115
3b4e076f-ab29-4793-9d78-e5f55c31195d,2024-08-02,VIDEO,3008,420,500,3928
c30daaad-dee1-4909-9097-332be2f542f6,2024-09-14,REELS,3363,667,479,4509
f95d6444-9c44-49ac-9df8-4ab694077d81,2024-06-17,STATIC_POST,4875,405,295,5575
d705e2fa-1a2f-4c1e-af1d-351fb530018e,2024-03-05,REELS,515,30,140,685
5acc34d3-9c85-47a7-a0e5-8f592744fedf,2024-10-01,TEXT,828,877,432,2137
5ba0448f-9329-44fb-954d-8be8dcee711f,2024-03-08,TEXT,4136,718,239,5093
bbb4b0aa-425c-4cfc-9838-ae3d88026779,2024-09-04,REELS,2424,583,478,3485
cb3cd350-f53e-4127-8c5f-6c0f7073b823,2024-10-16,TEXT,912,549,461,1922
74881e88-8d31-4dbd-9588-530f8a947b45,2024-08-26,VIDEO,3867,472,468,4807
2093bc06-babe-4f66-9137-bcd4831fbb6e,2024-04-13,REELS,1859,131,33,2023
f73371fd-ba9a-44a8-b5e9-9b366748d5fc,2024-05-29,REELS,3046,702,314,4062
1fa13c1d-a319-414b-86ee-bc5eb7632089,2024-12-20,REELS,3833,867,13,4713
b1c9ad63-5d50-4ab1-9b7b-2f6f98f0bbb5,2024-12-04,STATIC_POST,425,58,209,692
6c24fbc7-b4c4-41bc-9632-9e5f648f5672,2024-08-25,VIDEO,3576,145,228,3949
3c52eba2-a4d0-4e18-ac0a-06fa85dea65a,2024-01-22,VIDEO,2020,635,275,2930
ff0793d3-cdae-498c-82ea-375b2ab193f4,2024-11-10,REELS,2176,771,332,3279
b06ad960-2560-41ef-831e-fda68ffe58fd,2024-06-29,REELS,2078,745,291,3114
00174b5c-b248-47b6-b1de-0154f0e63ea3,2024-04-23,REELS,4126,908,218,5252
10ed5d3f-7b38-41b4-a550-50f3a2f13d9b,2024-04-27,STATIC_POST,2031,743,368,3142
17733ff4-3348-4c7f-9560-b0b9bfc736fc,2024-09-15,TEXT,4971,852,453,6276
0cf0a3a4-8c4c-47bd-a69a-25e7a9a9420e,2024-11-06,TEXT,337,377,285,999
2d082f13-6006-4510-8804-0d026e45757c,2024-03-26,REELS,4006,763,287,5056
e93102e7-d4bd-460c-a989-4cd34df6d93c,2024-07-29,REELS,3166,193,392,3751
f6ba7e0b-fd64-4c9a-bd14-b2838dd2c2e6,2024-12-10,TEXT,1803,826,347,2976
5220806a-9226-4571-b4d8-524527a2050e,2024-03-07,TEXT,4527,748,388,5663
5a56246a-9a62-4e2a-a40e-26c39cf81d36,2024-04-10,VIDEO,3719,409,367,4495
f9c6c553-4eb5-4973-91ae-9cf7afcadab1,2024-07-15,TEXT,1347,552,181,2080
3ccf477f-52a2-43c8-8619-d795073c0448,2024-09-22,VIDEO,3618,114,371,4103
20afccd7-2bae-4e75-a486-294c52e7f2ab,2024-01-09,REELS,4150,221,27,4398
60e9797a-1611-43b1-bffc-62cd1c360525,2024-12-25,REELS,935,974,117,2026
9e1bb7c8-945c-440d-8bc7-29222f6532fb,2024-09-16,VIDEO,3385,872,127,4384
9597a16a-3eb9-4922-9079-fead39d55f9f,2024-04-21,TEXT,1983,735,387,3105
0c0b53f6-8397-451a-bf6c-52e707c06309,2024-09-08,STATIC_POST,4401,65,96,4562
bc431229-10c4-438e-9a7f-0799bccfb043,2024-02-21,REELS,662,668,52,1382
e2bc69cd-edb3-493b-96c8-bd6997ae35db,2024-07-15,VIDEO,3740,218,202,4160
9da28db1-b04d-47f1-912e-7e10979fc4c1,2024-11-21,STATIC_POST,3756,420,25,4201
49f1f5af-dde0-4db2-8170-a9fb4b6b3752,2024-03-27,VIDEO,2696,747,272,3715
1d07388c-f4d3-453b-aab5-fd9ef655436c,2024-04-06,REELS,1887,229,297,2413
596d5b29-e42d-4105-a278-754444389f7d,2024-05-04,REELS,2210,761,472,3443
a52f995e-d550-48b7-adc6-3fff6d7ef4d8,2024-09-04,VIDEO,4868,934,372,6174
2c01a9eb-3e1a-4d30-a61c-8d23d415fbce,2024-07-16,STATIC_POST,809,870,18,1697
5492c740-eadd-47e4-9a42-c3b8d12248a2,2024-08-10,VIDEO,1461,700,433,2594
b896daee-ec12-4d45-98fc-93f2e73b1d53,2024-05-26,VIDEO,4583,247,9,4839
1101eb96-5d85-4742-95ec-f0f9aa317817,2024-12-30,VIDEO,1871,324,276,2471
69db8b01-b73d-4014-83b7-ee6d7a8b3537,2024-11-06,STATIC_POST,2155,329,384,2868
ffa54282-3fb5-4b5f-b462-4399b5e2e7a1,2024-10-03,REELS,399,632,244,1275
a06c14d8-19f2-44fc-972d-60390759bba3,2024-02-21,REELS,832,480,11,1323
c98a4078-1d9a-4480-bda9-38d4787c7fbd,2024-12-18,REELS,2835,199,278,3312
eddf3a49-06c2-4680-978e-a03212036744,2024-03-09,REELS,60,953,236,1249
a94db8d3-0dcc-4af8-b035-6df4d77b861d,2024-03-29,STATIC_POST,688,557,454,1699
0fd0fb73-5101-40bb-a3ae-97c73cd50a55,2024-07-24,TEXT,2900,26,424,3350
806e0cf2-68c5-4a19-8579-39c36278a2a0,2024-01-12,REELS,177,719,73,969
4d037586-6e26-414a-96b3-493d4d25feb2,2024-07-17,VIDEO,4603,635,263,5501
b644e620-f43f-499e-98ce-d41c438f8f5d,2024-02-25,REELS,2179,657,144,2980
16f4c658-b20c-4393-a61b-3383ffd19ed7,2024-08-07,REELS,929,633,428,1990
6718b4c6-548a-4aa5-b5fd-117e1e265a57,2024-12-05,REELS,680,182,432,1294
a51a9bff-9b99-48c2-8127-2489a45e33e5,2024-03-09,REELS,310,278,284,872
953190da-0c16-4c58-85ca-a21685de9323,2024-11-17,TEXT,1621,179,225,2025
3a5bb991-10d8-4a39-a74b-b09a2abe1675,2024-10-22,STATIC_POST,1373,98,484,1955
1e5228d5-819a-4230-993a-0010076ad1c4,2024-09-04,TEXT,1348,986,472,2806
f9feaba4-082b-443e-80f9-c476cb4445fb,2024-08-10,STATIC_POST,3708,473,54,4235
ded1ca46-a22b-438b-a2c7-33e00d56a89f,2024-06-10,REELS,230,687,199,1116
39136da3-31e3-4419-b15c-0c62c5248256,2024-11-27,VIDEO,2451,929,485,3865
ff239180-1f6e-4899-bab5-afc8d87b08bc,2024-04-30,STATIC_POST,1847,784,303,2934
a641056e-9ffb-4e4d-9148-dc16f8027366,2024-11-29,REELS,2691,710,337,3738
b63d3adc-9f27-4b2b-b014-090223d957de,2024-04-18,STATIC_POST,2028,311,50,2389
4c6d64bb-1bd5-47fb-bfaf-d5318006b2b2,2024-06-21,VIDEO,2516,262,163,2941
50e97352-c630-4d90-8fe0-d4d86a408aad,2024-08-29,REELS,2989,389,286,3664
97f11b52-1771-47ae-85bc-bc23e8ad42b5,2024-12-01,TEXT,2773,565,381,3719
5a638f31-6b1f-47f7-ad94-f1f1ad7ca37f,2024-05-28,STATIC_POST,407,770,375,1552
57a68420-afb8-411a-97ad-92dfdc11f066,2024-03-04,TEXT,137,877,177,1191
af0c40f5-1ecd-46d6-8579-11fd692a194f,2024-08-26,REELS,589,916,103,1608
25dff378-c48e-40a0-83e7-f35d1ed9ff17,2024-12-02,STATIC_POST,1438,59,438,1935
dbf32ebb-0343-4f7b-a0fb-8ecc8f1d553e,2024-12-11,REELS,208,181,308,697
a326cbff-928b-455b-9435-f732500fdf23,2024-03-05,STATIC_POST,4064,921,46,5031
d5c3a6d7-a0f1-49f9-bdd4-b3cef780e721,2024-05-18,VIDEO,118,927,458,1503
ff1cf69a-f62a-43e4-96a8-8d4e38590d8d,2024-12-17,TEXT,1431,590,455,2476
90c23050-fb70-4321-9332-cbce8230a7d0,2024-11-02,VIDEO,3781,345,156,4282
e660274d-63c1-4cbc-9626-4682f5a8826a,2024-02-11,TEXT,384,531,490,1405
71d7b9a1-5cb6-4c93-b894-489e6d1a1a85,2024-08-03,VIDEO,441,6,120,567
874d8d7a-68c0-4bb4-b0a9-2dd9eb9e2a24,2024-05-18,VIDEO,60,301,291,652
25574d6c-17c3-450e-b3d7-6176cbfb554b,2024-02-26,STATIC_POST,610,739,397,1746
a5863618-48a4-44c1-85ef-8689f15e110e,2024-01-22,TEXT,1105,445,392,1942
d2085baa-ddc6-416f-92da-17a4ca0c17cd,2024-10-06,STATIC_POST,43,790,396,1229
2076c883-b7a6-4c28-a011-72cfa7068576,2024-12-09,TEXT,2636,359,184,3179
1fc5ae47-f0d0-4bee-85db-b7506141dbcd,2024-02-11,TEXT,4993,239,399,5631
6a45b688-5145-4044-8464-e6e1ef6b20a9,2024-12-14,TEXT,3709,13,34,3756
86c1485a-87e5-486c-8a41-d48c7a9f5418,2024-01-07,REELS,3601,818,390,4809
120cf9ec-4a7c-489a-b976-f2e77df3dca8,2024-08-05,VIDEO,2738,25,346,3109
c55f5715-5474-434b-827c-7bff706c68fa,2024-10-25,STATIC_POST,924,353,22,1299
34e7beb9-3152-4ed6-a26e-861cc0e968f4,2024-03-28,TEXT,4522,758,119,5399
db99369e-7ef2-41a1-a4b8-53561e3afec7,2024-12-12,STATIC_POST,4809,401,399,5609
915a4b95-4a9d-45b4-a024-7c8510845241,2024-02-13,TEXT,2614,157,57,2828
c29e88d5-b3e9-47b6-a8ab-f265fc15a025,2024-09-13,REELS,510,173,92,775
aad68dfe-d36b-420f-8cf4-6b599c3e1dfc,2024-05-30,TEXT,614,929,215,1758
253e13f7-6809-4073-ad28-aafabfcaf330,2024-04-18,REELS,4323,702,153,5178
262a45b7-1172-419b-a655-c934bb6a496d,2024-03-11,REELS,1318,586,418,2322
9a49db63-f669-4861-ad03-c7e2618a15f7,2024-02-20,STATIC_POST,1047,132,418,1597
